rows 30
cols 30
players 2
agents_per_player 1
a 28 4 n 0
a 13 19 n 1
m ..............................
m ..............................
m .............%%...............
m .....%..%.....%...............
m .....%..%%....................
m ......%%%.....................
m ..............................
m ..............................
m ...................%%.........
m ..............................
m ..............................
m ..............................
m ..............................
m ..............................
m ..............................
m ..............................
m ..............................
m ............................%%
m ....................%..%.....%
m ....................%..%%.....
m .....................%%%......
m ..............................
m ..............................
m ....%%........................
m ..............................
m ..............................
m ..............................
m ..............................
m ..............................
m ..............................
