rows 14
cols 28
players 2
agents_per_player 1
a 8 4 n 0
a 1 18 n 1
m ............................
m ............................
m ............................
m .%%.......%.........%.......
m ..........%.........%%%%....
m ....................%%%%....
m ....................%%%.....
m ............................
m ............................
m ............................
m ......%........%%.......%...
m ......%%%%..............%...
m ......%%%%..................
m ......%%%...................
