rows 30
cols 28
players 2
agents_per_player 1
a 4 27 n 0
a 19 13 n 1
m ..............%%%...........
m .............%%%%...........
m .............%.....%%.......
m ...................%........
m ............................
m .....%%................%%...
m .%%.%%................%%%...
m ....%%.................%....
m ....%%......................
m ..%.%%%.....................
m ..%.%.......................
m ..%.........................
m ............................
m ..........................%.
m ..........................%.
m %%%.........................
m %%%........................%
m .....%%....................%
m .....%......................
m ............................
m .........%%........%%.......
m ........%%%....%%.%%........
m .........%........%%........
m ..................%%........
m ................%.%%%.......
m ................%.%.........
m ................%...........
m ............................
m ............%...............
m ............%...............
