rows 40
cols 32
players 8
agents_per_player 1
a 31 18 n 0
a 26 14 n 1
a 21 10 n 2
a 16 6 n 3
a 11 2 n 4
a 6 30 n 5
a 1 26 n 6
a 36 22 n 7
m .............%%.................
m ..............%.................
m ................................
m .......................%%.......
m .......................%%.......
m .................%%.............
m ..................%.............
m ................................
m ...........................%%...
m ...........................%%...
m .....................%%.........
m ......................%.........
m ................................
m %..............................%
m %..............................%
m .........................%%.....
m ..........................%.....
m ................................
m ...%%...........................
m ...%%...........................
m .............................%%.
m ..............................%.
m ................................
m .......%%.......................
m .......%%.......................
m .%%.............................
m ..%.............................
m ................................
m ...........%%...................
m ...........%%...................
m .....%%.........................
m ......%.........................
m ................................
m ...............%%...............
m ...............%%...............
m .........%%.....................
m ..........%.....................
m ................................
m ...................%%...........
m ...................%%...........
