rows 20
cols 16
players 2
agents_per_player 1
a 0 7 n 0
a 10 15 n 1
m ................
m ............%%..
m ................
m ................
m ................
m ................
m ................
m ................
m ................
m ................
m ................
m ....%%..........
m ................
m ................
m ................
m ................
m ................
m ................
m ................
m ................
