rows 28
cols 30
players 2
agents_per_player 1
a 23 20 n 0
a 9 5 n 1
m .......................%......
m .......................%......
m .......................%......
m .......................%......
m ..............................
m ..............................
m ..........%...................
m ..........%%..................
m ..................%%%.........
m ..............................
m ..............................
m ...................%%.........
m ..................%%..........
m ..............................
m ........%.....................
m ........%.....................
m ........%.....................
m ........%.....................
m ..............................
m ..............................
m .........................%....
m .........................%%...
m ...%%%........................
m ..............................
m ..............................
m ....%%........................
m ...%%.........................
m ..............................
