rows 26
cols 30
players 2
agents_per_player 1
a 12 19 n 0
a 25 4 n 1
m ..................%...........
m ..................%...........
m .............%................
m .............%................
m ..............................
m ..............................
m ...........%%%................
m ..............................
m ..............................
m ..............................
m ..........%...................
m ..........%...................
m ..............................
m ...%..........................
m ...%..........................
m ............................%.
m ............................%.
m ..............................
m ..............................
m ..........................%%%.
m ..............................
m ..............................
m ..............................
m .........................%....
m .........................%....
m ..............................
