rows 21
cols 21
players 3
agents_per_player 1
a 7 16 n 0
a 0 2 n 1
a 14 9 n 2
m .....................
m .....................
m ........%............
m ......%.%............
m ......%%.............
m .....%%%.............
m .....................
m .....................
m .....................
m .%...................
m .%..................%
m %...................%
m %..................%%
m .....................
m .....................
m .....................
m ...............%.....
m .............%.%.....
m .............%%......
m ............%%%......
m .....................
