rows 70
cols 70
players 10
agents_per_player 1
a 68 56 n 0
a 47 49 n 1
a 26 42 n 2
a 5 35 n 3
a 54 28 n 4
a 33 21 n 5
a 12 14 n 6
a 61 7 n 7
a 40 0 n 8
a 19 63 n 9
m ....%....................%%%..........................................
m ....%.................................................................
m .............................%........................................
m ............................%%%.......................................
m ....%%%.....................%.................%..%%%..................
m ....%%%.......................................%%%%%...................
m ....%%%%%.........................................%%%%................
m ....%%%..............................................%................
m .....................................................%................
m ........%.............................................................
m .......%%%............................................................
m .......%.................%..%%%......................%%%..............
m .........................%%%%%.......................%%%..............
m .............................%%%%....................%%%%%............
m ................................%....................%%%..............
m ................................%.....................................
m .........................................................%............
m ........................................................%%%...........
m ....%..%%%......................%%%.....................%.............
m ....%%%%%.......................%%%...................................
m ........%%%%....................%%%%%.................................
m ...........%....................%%%...................................
m ...........%..........................................................
m ....................................%.................................
m ...................................%%%................................
m ...........%%%.....................%.................%..%%%...........
m ...........%%%.......................................%%%%%............
m ...........%%%%%.........................................%%%%.........
m ...........%%%..............................................%.........
m ............................................................%.........
m ...............%......................................................
m ..............%%%.....................................................
m ..............%.................%..%%%......................%%%.......
m ................................%%%%%.......................%%%.......
m ....................................%%%%....................%%%%%.....
m .......................................%....................%%%.......
m .......................................%..............................
m ................................................................%.....
m ...............................................................%%%....
m ...........%..%%%......................%%%.....................%......
m ...........%%%%%.......................%%%............................
m ...............%%%%....................%%%%%..........................
m ..................%....................%%%............................
m ..................%...................................................
m ...........................................%..........................
m ..........................................%%%.........................
m ..................%%%.....................%.................%..%%%....
m ..................%%%.......................................%%%%%.....
m ..................%%%%%.........................................%%%%..
m ..................%%%..............................................%..
m ...................................................................%..
m ......................%...............................................
m .....................%%%..............................................
m .....................%.................%..%%%......................%%%
m .......................................%%%%%.......................%%%
m %%.........................................%%%%....................%%%
m ..............................................%....................%%%
m ..............................................%.......................
m .%....................................................................
m %%%...................................................................
m %.................%..%%%......................%%%.....................
m ..................%%%%%.......................%%%.....................
m ......................%%%%....................%%%%%...................
m .........................%....................%%%.....................
m .........................%............................................
m ..................................................%...................
m .................................................%%%..................
m %%%......................%%%.....................%.................%..
m %%.......................%%%.......................................%%%
m .%%%%....................%%%%%........................................
