rows 28
cols 28
players 4
agents_per_player 1
a 18 4 n 0
a 11 25 n 1
a 4 18 n 2
a 25 11 n 3
m .....................%%%%...
m ......%%..........%...%.....
m .......%..........%.......%%
m ......%%....................
m ............................
m .%..........................
m %%%.........................
m %%%%........................
m .%...........%%..........%..
m .....%%.......%..........%..
m .............%%.............
m ............................
m ........%...................
m .......%%%..................
m .......%%%%.................
m ....%...%...........%%......
m ....%.......%%.......%......
m ....................%%......
m ............................
m ...............%............
m ..............%%%...........
m ..............%%%%..........
m %..........%...%...........%
m %..........%.......%%.......
m %..........................%
m ............................
m ......................%.....
m .....................%%%....
