rows 30
cols 30
players 2
agents_per_player 1
a 12 26 n 0
a 27 11 n 1
m %%...........................%
m %%..........................%%
m ............................%%
m ..............................
m .....%%.......................
m .....%%%%.....................
m .....%%%%..%%%................
m ......%....%%.................
m ...........%..................
m ..............................
m ..............................
m ..............................
m ..............................
m ..............................
m ..............................
m ..............%%%.............
m .............%%%%.............
m .............%%...............
m ..............................
m ....................%%........
m ....................%%%%......
m ....................%%%%..%%%.
m .....................%....%%..
m ..........................%...
m ..............................
m ..............................
m ..............................
m ..............................
m ..............................
m ..............................
