rows 30
cols 30
players 2
agents_per_player 1
a 8 4 n 0
a 23 19 n 1
m ..............................
m ............%.................
m ............%.................
m ............%%................
m ..........%%................%%
m .....%.....%...............%%.
m .....%....................%%%.
m %........................%%%%%
m ...............%.........%%%%%
m ..............%%.........%%%%%
m %%..........................%%
m .............................%
m ..............................
m ..............................
m ..............................
m ..............................
m ...........................%..
m ...........................%..
m ...........................%%.
m .............%%..........%%...
m ............%%......%.....%...
m ...........%%%......%.........
m ..........%%%%%%..............
m %.........%%%%%...............
m %.........%%%%%..............%
m .............%%%%.............
m ..............%...............
m ..............................
m ..............................
m ..............................
