rows 28
cols 24
players 2
agents_per_player 1
a 24 2 n 0
a 10 14 n 1
m ........%%%%%%..........
m .........%%%%%..........
m .........%..%%%.........
m ........................
m ........................
m ........................
m ........................
m ........................
m ........................
m ........................
m ........................
m .%%.....................
m ........................
m ........................
m %%..................%%%%
m %%...................%%%
m %%%..................%..
m ........................
m ........................
m ........................
m ........................
m ........................
m ........................
m ........................
m ........................
m .............%%.........
m ........................
m ........................
