rows 30
cols 28
players 2
agents_per_player 1
a 25 5 n 0
a 10 19 n 1
m ............................
m ............................
m ............................
m ...%.....%..................
m ..%%%..%%%%.................
m %%%%%.......................
m %%%%%%......................
m %%%%.%%.....................
m ............................
m ............................
m ............................
m ............................
m ........................%%..
m .........................%%%
m .........................%..
m ............................
m ............................
m ............................
m .................%.....%....
m ................%%%..%%%%...
m ..............%%%%%.........
m ..............%%%%%%........
m ..............%%%%.%%.......
m ............................
m ............................
m ............................
m ............................
m ..........%%................
m ...........%%%..............
m ...........%................
