rows 22
cols 18
players 2
agents_per_player 1
a 20 11 n 0
a 9 2 n 1
m ..................
m ..................
m ..................
m ..................
m .............%%...
m ..............%...
m ..................
m ..................
m ..................
m ..................
m ..................
m ..................
m ..................
m ..................
m ..................
m ....%%............
m .....%............
m ..................
m ..................
m ..................
m ..................
m ..................
