rows 24
cols 28
players 2
agents_per_player 1
a 7 24 n 0
a 19 10 n 1
m %%%.....................%%%%
m %%%....%.................%%.
m .%%....%.%............%%....
m .%.....%%%..................
m .%.....%....................
m .......%%...................
m .......%....................
m ............................
m .......%....................
m .......%....................
m ............................
m ..........%....%............
m ..........%%%%%%%...........
m ...........%%.%%%....%......
m ........%%.....%%....%.%....
m ...............%.....%%%....
m ...............%.....%......
m .....................%%.....
m .....................%......
m ............................
m .....................%......
m .....................%......
m ............................
m .%......................%...
