rows 30
cols 24
players 2
agents_per_player 1
a 23 20 n 0
a 8 8 n 1
m ........................
m .................%.%....
m .................%%%....
m ................%%%%....
m .................%%.%...
m ....................%.%.
m ....................%%%.
m ........................
m ........................
m ..............%%%.......
m ...............%........
m ........................
m ........................
m ...............%%%......
m ........................
m ........................
m .....%.%................
m .....%%%................
m ....%%%%................
m .....%%.%...............
m ........%.%.............
m ........%%%.............
m ........................
m ........................
m ..%%%...................
m ...%....................
m ........................
m ........................
m ...%%%..................
m ........................
