rows 27
cols 24
players 3
agents_per_player 1
a 5 18 n 0
a 23 2 n 1
a 14 10 n 2
m .......%%...............
m ......%%................
m ........................
m ........................
m ........................
m ........................
m ........................
m ........................
m .......................%
m %......................%
m ......................%%
m ........................
m ........................
m ........................
m ........................
m ........................
m ........................
m ...............%........
m ...............%%.......
m ..............%%........
m ........................
m ........................
m ........................
m ........................
m ........................
m ........................
m .......%................
