rows 36
cols 42
players 6
agents_per_player 1
a 13 17 n 0
a 7 10 n 1
a 1 3 n 2
a 31 38 n 3
a 25 31 n 4
a 19 24 n 5
m .............................%%%..........
m .............................%%%%.........
m ...........%%................%%%..........
m ...........%%%%.............%%%...........
m ............................%.............
m ..........................................
m ....................................%%%...
m ....................................%%%%..
m ..................%%................%%%...
m ..................%%%%.............%%%....
m ...................................%......
m ..........................................
m .%%%......................................
m .%%%%.....................................
m .%%%.....................%%...............
m %%%......................%%%%.............
m %.........................................
m ..........................................
m ........%%%...............................
m ........%%%%..............................
m ........%%%.....................%%........
m .......%%%......................%%%%......
m .......%..................................
m ..........................................
m ...............%%%........................
m ...............%%%%.......................
m ...............%%%.....................%%.
m %.............%%%......................%%%
m ..............%...........................
m ..........................................
m ......................%%%.................
m ......................%%%%................
m ....%%................%%%.................
m ....%%%%.............%%%..................
m .....................%....................
m ..........................................
