rows 42
cols 42
players 6
agents_per_player 1
a 30 5 n 0
a 23 40 n 1
a 16 33 n 2
a 9 26 n 3
a 2 19 n 4
a 37 12 n 5
m .....%%.................................%%
m %......................................%%%
m ...........%......................%....%..
m .....%....%%......................%.......
m .....%....%%..............................
m ....%%....%%%.............................
m .................................%%%......
m .....%%.....%%............................
m ....%%%%..................................
m ....%.............%......................%
m ............%....%%......................%
m ............%....%%.......................
m ...........%%....%%%......................
m %.......................................%%
m ............%%.....%%.....................
m ...........%%%%...........................
m ......%....%.............%................
m ......%............%....%%................
m ...................%....%%................
m ..................%%....%%%...............
m .....%%%..................................
m ...................%%.....%%..............
m ..................%%%%....................
m .............%....%.............%.........
m .............%............%....%%.........
m ..........................%....%%.........
m .........................%%....%%%........
m ............%%%...........................
m ..........................%%.....%%.......
m .........................%%%%.............
m ....................%....%.............%..
m ....................%............%....%%..
m .................................%....%%..
m ................................%%....%%%.
m ...................%%%....................
m .................................%%.....%%
m ................................%%%%......
m ....%......................%....%.........
m ...%%......................%............%.
m ...%%...................................%.
m ...%%%.................................%%.
m ..........................%%%.............
