rows 18
cols 16
players 2
agents_per_player 1
a 17 8 n 0
a 8 0 n 1
m ......%.........
m ....%.%%........
m ....%%%.........
m ................
m ................
m ........%.......
m ........%.......
m ................
m ................
m ..............%.
m ............%.%%
m ............%%%.
m ................
m ................
m %...............
m %...............
m ................
m ................
