rows 42
cols 35
players 7
agents_per_player 1
a 19 24 n 0
a 1 29 n 1
a 25 34 n 2
a 7 4 n 3
a 31 9 n 4
a 13 14 n 5
a 37 19 n 6
m .............................%%....
m %%.................................
m %%.................................
m ...................................
m ...................................
m ...................................
m ....%%.............................
m ..........%%.......................
m ..........%%.......................
m ...................................
m ...................................
m ...................................
m ..............%%...................
m ....................%%.............
m ....................%%.............
m ...................................
m ...................................
m ...................................
m ........................%%.........
m ..............................%%...
m ..............................%%...
m ...................................
m ...................................
m ...................................
m %.................................%
m .....%%............................
m .....%%............................
m ...................................
m ...................................
m ...................................
m .........%%........................
m ...............%%..................
m ...............%%..................
m ...................................
m ...................................
m ...................................
m ...................%%..............
m .........................%%........
m .........................%%........
m ...................................
m ...................................
m ...................................
