rows 26
cols 22
players 2
agents_per_player 1
a 22 6 n 0
a 9 17 n 1
m .................%....
m ....%......%%....%....
m ....%%......%.........
m ....%%......%.........
m ......................
m ......................
m ....%%................
m ....%%................
m ...%%%................
m ...%.%................
m ..%%..................
m ..................%%..
m ......................
m ......%...............
m %%....%........%......
m .%.............%%.....
m .%.............%%.....
m ......................
m ......................
m ...............%%.....
m ...............%%.....
m ..............%%%.....
m ..............%.%.....
m .............%%.......
m .......%%.............
m ......................
