rows 30
cols 30
players 2
agents_per_player 1
a 10 10 n 0
a 25 25 n 1
m ...............%%.%%..%%......
m ...............%......%.......
m ..............................
m ...........................%..
m ...........................%..
m ..............................
m ..............................
m ............................%.
m ............................%.
m .........................%%...
m ..............................
m %%%...........................
m ..............................
m ..............................
m ...%%.........................
m %%.%%..%%.....................
m %......%......................
m ..............................
m ............%.................
m ............%.................
m ..............................
m ..............................
m .............%................
m .............%................
m ..........%%..................
m ..............................
m ...............%%%............
m ..............................
m ..............................
m ..................%%..........
