rows 42
cols 49
players 7
agents_per_player 1
a 41 1 n 0
a 35 8 n 1
a 29 15 n 2
a 23 22 n 3
a 17 29 n 4
a 11 36 n 5
a 5 43 n 6
m ...........%%....................................
m .................................................
m .................................................
m .......%%..............%%........................
m .......................%.........................
m .......%%........................................
m ....%%...........................................
m .................................................
m .................................................
m %%..............%%...............................
m ................%................................
m %%...............................................
m ..............................................%%.
m .................................................
m .................................................
m .........%%...............................%%.....
m .........%.......................................
m ..........................................%%.....
m .......................................%%........
m .................................................
m .................................................
m ..%%...............................%%............
m ..%..............................................
m ...................................%%............
m ................................%%...............
m .................................................
m .................................................
m ............................%%..............%%...
m ............................................%....
m ............................%%...................
m .........................%%......................
m .................................................
m .................................................
m .....................%%..............%%..........
m .....................................%...........
m .....................%%..........................
m ..................%%.............................
m .................................................
m .................................................
m ..............%%..............%%.................
m ..............................%..................
m ..............%%.................................
