rows 35
cols 35
players 5
agents_per_player 1
a 20 10 n 0
a 13 31 n 1
a 6 17 n 2
a 34 3 n 3
a 27 24 n 4
m ...................................
m ...................%...............
m ...%%.............%%........%%.....
m ..................%.......%%%%%%...
m ..........................%%.......
m ...................................
m ...................................
m ...................................
m .................................%.
m .......%%........%%.............%%.
m .....%%%%%%.....................%..
m .....%%............................
m ...................................
m ...................................
m ...................................
m ............%......................
m ...........%%........%%........%%..
m ...........%.......%%%%%%..........
m ...................%%..............
m ...................................
m ...................................
m ...................................
m ..........................%........
m %%........%%.............%%........
m %%%%.....................%.......%%
m .................................%%
m ...................................
m ...................................
m ...................................
m .....%.............................
m ....%%........%%........%%.........
m ....%.......%%%%%%.................
m ............%%.....................
m ...................................
m ...................................
