rows 28
cols 24
players 2
agents_per_player 1
a 15 8 n 0
a 1 20 n 1
m ........................
m ........................
m ........................
m ....%%..................
m .....%..................
m .....%.%%%%.............
m .......%%...............
m ........................
m ........................
m ........................
m ........................
m ........................
m ........................
m ........................
m ........................
m ........................
m ........................
m ................%%......
m .................%......
m .................%.%%%%.
m ...................%%...
m ........................
m ........................
m ........................
m ........................
m ........................
m ........................
m ........................
