rows 30
cols 26
players 2
agents_per_player 1
a 9 15 n 0
a 24 2 n 1
m ..........................
m ..........................
m ..........................
m ........%.................
m .......%%.................
m ..........................
m ..........................
m ..........................
m ..........................
m ....%%....................
m .......................%%.
m .......................%..
m ..%%......................
m ..........................
m ..........................
m ..........................
m ..........................
m ..........................
m .....................%....
m ....................%%....
m ..........................
m ..........................
m ..........................
m ..........................
m .................%%.......
m ..........%%..............
m ..........%...............
m ...............%%.........
m ..........................
m ..........................
