rows 24
cols 28
players 2
agents_per_player 1
a 11 8 n 0
a 23 22 n 1
m ..................%%%.......
m ............................
m .................%%%........
m .......................%....
m ......%................%....
m ......%.....................
m .....%......................
m .....%.%%...................
m .......%%%..................
m ......%%%%%.................
m ......%%%%..................
m ....%%%%....................
m ....%%%.....................
m ............................
m ...%%%......................
m .........%..................
m .........%..........%.......
m ....................%.......
m ...................%........
m ...................%.%%.....
m .....................%%%....
m ....................%%%%%...
m ....................%%%%....
m ..................%%%%......
