rows 30
cols 35
players 5
agents_per_player 1
a 9 23 n 0
a 27 2 n 1
a 15 16 n 2
a 3 30 n 3
a 21 9 n 4
m ..........%%................%%.....
m ..........%%.......................
m ...................................
m ...............%%%.................
m ..........%%.......................
m ..........%........................
m ...%%................%%............
m ...%%..............................
m ...................................
m ........%%%........................
m ...%%..............................
m ...%...............................
m ..............%%...............%%..
m ...............................%%..
m ...................................
m .%%%...............................
m ...............................%%..
m ...............................%...
m .......%%...............%%.........
m ........................%%.........
m ...................................
m .............................%%%...
m ........................%%.........
m ........................%..........
m %%...............%%................
m .................%%................
m ...................................
m ......................%%%..........
m .................%%................
m .................%.................
