rows 22
cols 22
players 2
agents_per_player 1
a 12 8 n 0
a 1 19 n 1
m .......%..............
m .......%%%.....%......
m ...............%%.....
m ........%.............
m ......%%%.............
m ......................
m ................%%....
m ......................
m ......................
m ......................
m .................%%...
m ..................%...
m ....%.............%%%.
m ....%%................
m ...................%..
m .................%%%..
m ......................
m .....%%...............
m ......................
m ......................
m ......................
m ......%%..............
