rows 20
cols 16
players 2
agents_per_player 1
a 3 6 n 0
a 13 14 n 1
m ......%%...%%...
m ............%...
m ................
m ............%...
m ............%...
m ................
m ................
m ........%%......
m ................
m %..%%..........%
m ...%%.........%%
m ....%...........
m ................
m ....%...........
m ....%...........
m ................
m ................
m %%..............
m ................
m .......%%..%%...
