rows 30
cols 28
players 2
agents_per_player 1
a 9 20 n 0
a 24 6 n 1
m .....%...%%%%......%%%......
m .....%....%%%...............
m .....%......................
m .....%......................
m ..........%.................
m .........%%%................
m ............................
m ............................
m ............................
m .........%.......%%%........
m ........%%%......%..........
m ........%%%.................
m ........%%%.................
m ..........%.................
m .....%%%....................
m .....%%%...........%...%%%%.
m ...................%....%%%.
m ...................%........
m ...................%........
m ........................%...
m .......................%%%..
m ............................
m ............................
m ............................
m ...%%%.................%....
m ...%..................%%%...
m ......................%%%...
m ......................%%%...
m ........................%...
m ...................%%%......
