rows 42
cols 42
players 6
agents_per_player 1
a 10 22 n 0
a 3 15 n 1
a 38 8 n 2
a 31 1 n 3
a 24 36 n 4
a 17 29 n 5
m ..........................................
m ............................%%............
m %..........................%%%............
m %%.........................%%.............
m %%.............................%%.........
m ................................%.........
m ...%%.....................................
m ..........................................
m ...................................%%.....
m .......%..........................%%%.....
m .......%%.........................%%......
m .......%%.............................%%..
m .......................................%..
m ..........%%..............................
m ..........................................
m %%........................................
m %%............%..........................%
m %.............%%.........................%
m ...%%.........%%..........................
m ....%.....................................
m .................%%.......................
m ..........................................
m .......%%.................................
m ......%%%............%....................
m ......%%.............%%...................
m ..........%%.........%%...................
m ...........%..............................
m ........................%%................
m ..........................................
m ..............%%..........................
m .............%%%............%.............
m .............%%.............%%............
m .................%%.........%%............
m ..................%.......................
m ...............................%%.........
m ..........................................
m .....................%%...................
m ....................%%%............%......
m ....................%%.............%%.....
m ........................%%.........%%.....
m .........................%................
m ......................................%%..
