rows 30
cols 30
players 3
agents_per_player 1
a 5 17 n 0
a 15 27 n 1
a 25 7 n 2
m ...........................%..
m .......................%%..%..
m ........%%....................
m ..............................
m ..............................
m ..............................
m %%.......%.............%%%...%
m .%..%....%............%%......
m ....%...%%....................
m ..............................
m .......%......................
m ...%%..%......................
m ..................%%..........
m ..............................
m ..............................
m ..............................
m ...%%%...%%%.......%..........
m ..%%.......%..%....%..........
m ..............%...%%..........
m ..............................
m .................%............
m .............%%..%............
m ............................%%
m ..............................
m ..............................
m ..............................
m .............%%%...%%%.......%
m ............%%.......%..%....%
m ........................%...%%
m ..............................
