rows 30
cols 35
players 5
agents_per_player 1
a 29 2 n 0
a 17 30 n 1
a 5 23 n 2
a 23 16 n 3
a 11 9 n 4
m .............%%....................
m .....%%%%..........................
m ......%.......%..........%%%%......
m ..............%...........%%%......
m ...................................
m ...................................
m %.................................%
m ..........................%%%%.....
m %..........%%%%............%.......
m %...........%%%....................
m ...................................
m ...................................
m ....................%%.............
m ............%%%%...................
m %............%.......%..........%%%
m %....................%...........%%
m ...................................
m ...................................
m ......%%...........................
m %%...............................%%
m .......%..........%%%%............%
m .......%...........%%%.............
m ...................................
m ...................................
m ...........................%%......
m ...................%%%%............
m ....%%%%............%.......%......
m .....%%%....................%......
m ...................................
m ...................................
