rows 49
cols 42
players 7
agents_per_player 1
a 11 31 n 0
a 46 13 n 1
a 32 37 n 2
a 18 19 n 3
a 4 1 n 4
a 39 25 n 5
a 25 7 n 6
m ..........................................
m ..........................................
m ....................................%%....
m ....................................%%..%.
m ....................................%%%.%.
m ......................................%...
m ......................................%...
m ..........................................
m ..........................................
m ........................%%................
m ........................%%..%.............
m ........................%%%.%.............
m ..........................%...............
m ..........................%...............
m ..........................................
m ..........................................
m ............%%............................
m ............%%..%.........................
m ............%%%.%.........................
m ..............%...........................
m ..............%...........................
m ..........................................
m ..........................................
m %%........................................
m %%..%.....................................
m %%%.%.....................................
m ..%.......................................
m ..%.......................................
m ..........................................
m ..........................................
m ..............................%%..........
m ..............................%%..%.......
m ..............................%%%.%.......
m ................................%.........
m ................................%.........
m ..........................................
m ..........................................
m ..................%%......................
m ..................%%..%...................
m ..................%%%.%...................
m ....................%.....................
m ....................%.....................
m ..........................................
m ..........................................
m ......%%..................................
m ......%%..%...............................
m ......%%%.%...............................
m ........%.................................
m ........%.................................
