rows 30
cols 28
players 2
agents_per_player 1
a 17 22 n 0
a 2 8 n 1
m .........................%..
m ............................
m .................%%.........
m ............................
m ..%%%.......................
m ..........................%.
m ...........%....%.........%%
m ...........%....%%%........%
m ................%...%%......
m ............................
m ..........%.................
m %%%......%%%................
m ..%........%%.%%............
m .%%........%%...............
m ...........%%...............
m ...........%................
m ............................
m ...%%.......................
m ............................
m ................%%%.........
m ............%...............
m ..%.........%%...........%..
m ..%%%........%...........%..
m ..%...%%....................
m ............................
m ........................%...
m ..............%%%......%%%..
m %%..............%........%%.
m ...............%%........%%.
m .........................%%.
