rows 22
cols 20
players 2
agents_per_player 1
a 21 17 n 0
a 10 7 n 1
m ....................
m ....................
m ...............%....
m .......%.......%....
m %......%.......%....
m %%..................
m %%..................
m %..............%....
m ...............%....
m ..........%.%%......
m ..........%.........
m ....................
m ....................
m .....%..............
m .....%...........%..
m .....%....%......%..
m ..........%%........
m ..........%%........
m .....%....%.........
m .....%..............
m %.%%................
m %...................
