rows 30
cols 28
players 2
agents_per_player 1
a 13 1 n 0
a 28 15 n 1
m ............................
m ............................
m ..%.........................
m ..%.........................
m ............%.............%.
m ..%.........%%............%%
m ..%..........%...%%......%%%
m .................%..........
m .%%...............%%........
m ........................%%..
m ........................%%..
m ..............%%%...........
m ...............%............
m ............................
m ............................
m ............................
m ............................
m ................%...........
m ................%...........
m ............%.............%.
m ............%%..%.........%%
m ...%%......%%%..%..........%
m ...%........................
m ....%%.........%%...........
m ..........%%................
m ..........%%................
m %%%.........................
m .%..........................
m ............................
m ............................
