rows 30
cols 42
players 6
agents_per_player 1
a 1 39 n 0
a 6 32 n 1
a 11 25 n 2
a 16 18 n 3
a 21 11 n 4
a 26 4 n 5
m .....%%.......%%%.........................
m .....%%%......%%%.........................
m .......%......%%%...%.....................
m ..............%....%%.....................
m ..............%...........................
m .......%%%..............................%%
m %......%%%..............................%%
m %......%%%...%............................
m .......%....%%............................
m .......%..................................
m %%%..............................%%.......
m %%%..............................%%%......
m %%%...%............................%......
m %....%%...................................
m %.........................................
m ..........................%%.......%%%....
m ..........................%%%......%%%....
m ............................%......%%%...%
m ...................................%....%%
m ...................................%......
m ...................%%.......%%%...........
m ...................%%%......%%%...........
m .....................%......%%%...%.......
m ............................%....%%.......
m ............................%.............
m ............%%.......%%%..................
m ............%%%......%%%..................
m ..............%......%%%...%..............
m .....................%....%%..............
m .....................%....................
