rows 24
cols 30
players 3
agents_per_player 1
a 12 13 n 0
a 4 23 n 1
a 20 3 n 2
m ..............................
m .......%%.....................
m ..............................
m ..............................
m ..............................
m ..............................
m ..............................
m ..............................
m ..............................
m ...........................%%.
m ..............................
m ..............................
m ..............................
m ..............................
m ..............................
m ..............................
m ..............................
m .................%%...........
m ..............................
m ..............................
m ..............................
m ..............................
m ..............................
m ..............................
