rows 30
cols 30
players 2
agents_per_player 1
a 18 17 n 0
a 3 2 n 1
m ..............................
m ..............................
m ..............................
m .............%.%..............
m .............%.%..............
m .........................%%...
m ...%..........................
m ...%..........................
m ..............................
m ..............................
m .......%%.....................
m ..............................
m ..............................
m ..............................
m ..............................
m ..............................
m ..............................
m ..............................
m %...........................%.
m %...........................%.
m ..........%%..................
m ..................%...........
m ..................%...........
m ..............................
m ..............................
m ......................%%......
m ..............................
m ..............................
m ..............................
m ..............................
