rows 20
cols 30
players 2
agents_per_player 1
a 3 4 n 0
a 13 19 n 1
m ..............................
m ..............................
m ..............................
m ..............%%..............
m ..............%...............
m ................%%............
m ..............................
m ..............................
m .....................%........
m .....................%........
m ..............................
m ..............................
m ..............................
m %............................%
m .............................%
m .%%...........................
m ..............................
m ..............................
m ......%.......................
m ......%.......................
