rows 21
cols 27
players 3
agents_per_player 1
a 4 13 n 0
a 18 22 n 1
a 11 4 n 2
m ...........................
m ...........................
m ........................%%.
m ..%.....................%..
m .%%.....................%..
m .%%........................
m ...........................
m ...........................
m ...........................
m ...............%%..........
m ...............%....%......
m ...............%...%%......
m ...................%%......
m ...........................
m ...........................
m ...........................
m ......%%...................
m ......%....%...............
m ......%...%%...............
m ..........%%...............
m ...........................
