rows 28
cols 28
players 4
agents_per_player 1
a 22 24 n 0
a 1 3 n 1
a 8 10 n 2
a 15 17 n 3
m ......................%.....
m .........................%%.
m ............................
m ............................
m ............................
m .%..........................
m .%%.........................
m .%..........................
m ....%%......................
m ............................
m ............................
m ............................
m ........%...................
m ........%%..................
m ........%...................
m ...........%%...............
m ............................
m ............................
m ............................
m ...............%............
m ...............%%...........
m ...............%............
m ..................%%........
m ............................
m ............................
m ............................
m ......................%.....
m ......................%%....
