rows 30
cols 30
players 3
agents_per_player 1
a 0 24 n 0
a 10 14 n 1
a 20 4 n 2
m ......%%%%%...................
m .........%....................
m ..............................
m ..............................
m ..............................
m ..............................
m ..............................
m .%%...........................
m ..%%.........................%
m %..........................%%%
m %.........................%%%%
m .............................%
m ..............................
m ..............................
m ..............................
m ..............................
m ..............................
m .....................%%.......
m ...................%..%%......
m .................%%%%.........
m ................%%%%%.........
m ...................%..........
m ..............................
m ..............................
m ..............................
m ..............................
m ..............................
m ...........%%.................
m .........%..%%................
m .......%%%%...................
