rows 14
cols 28
players 2
agents_per_player 1
a 3 7 n 0
a 10 21 n 1
m %........................%%.
m .........................%..
m .........%%.................
m ............................
m ............................
m ............................
m ...........%..%.............
m ...........%%.%.............
m ...........%................
m .......................%%...
m ............................
m ............................
m ............................
m %........................%..
