rows 24
cols 20
players 2
agents_per_player 1
a 3 2 n 0
a 15 12 n 1
m ....................
m .........%%%........
m ...........%%%%.....
m ............%%%.....
m ..........%....%....
m ..........%%...%%...
m ..........%%........
m ....................
m ....................
m ....................
m ....................
m ....................
m ....................
m %%.................%
m .%%%%...............
m ..%%%...............
m %....%..............
m %%...%%.............
m %%..................
m ....................
m ....................
m ....................
m ....................
m ....................
