rows 28
cols 28
players 4
agents_per_player 1
a 0 26 n 0
a 7 19 n 1
a 14 12 n 2
a 21 5 n 3
m ............................
m ..................%%........
m ..%%...............%........
m ..........%%................
m ............................
m .........................%%.
m ............................
m ............................
m ...........%%...............
m ............%..........%%...
m ...%%.......................
m ............................
m ..................%%........
m ............................
m ............................
m ....%%......................
m .....%..........%%..........
m ........................%%..
m ............................
m ...........%%...............
m ............................
m ............................
m .........................%%.
m .........%%...............%.
m .................%%.........
m ............................
m ....%%......................
m ............................
