rows 18
cols 26
players 2
agents_per_player 1
a 2 1 n 0
a 11 14 n 1
m ..........................
m ..........................
m ...........%........%%....
m ...........%..............
m ...........%%.............
m ...........%%.............
m ..........................
m ..............%...........
m ............%%%...........
m ..........................
m ..........................
m .......%%...............%.
m ........................%.
m ........................%%
m ........................%%
m ..........................
m .%........................
m %%.......................%
