rows 21
cols 21
players 3
agents_per_player 1
a 20 12 n 0
a 6 5 n 1
a 13 19 n 2
m .....................
m .....................
m .....................
m .....................
m .....................
m .................%%..
m .....................
m .....................
m .....................
m .....................
m .....................
m .....................
m ..........%%.........
m .....................
m .....................
m .....................
m .....................
m .....................
m .....................
m ...%%................
m .....................
