rows 30
cols 28
players 2
agents_per_player 1
a 3 10 n 0
a 18 24 n 1
m ...................%%.......
m ............................
m ............................
m ............................
m ............................
m ............................
m ............................
m ........%%..................
m ........%%..................
m .......%%%%.................
m .......%%%..................
m .......%%%..................
m ............................
m ............................
m ............................
m .....%%.....................
m ............................
m ............................
m ............................
m ............................
m ............................
m ............................
m ......................%%....
m ......................%%....
m .....................%%%%...
m .....................%%%....
m .....................%%%....
m ............................
m ............................
m ............................
