rows 35
cols 35
players 5
agents_per_player 1
a 30 13 n 0
a 16 20 n 1
a 2 27 n 2
a 23 34 n 3
a 9 6 n 4
m ...........%.......................
m .................................%.
m .................................%.
m ................%%...%%............
m ......................%%%%%........
m .......................%%%%........
m .........................%.........
m .........................%.........
m ............%......................
m ............%......................
m %%............................%%...
m .%%%%%.............................
m ..%%%%.............................
m ....%..............................
m ....%..............................
m ..........................%........
m ..........................%........
m .........%%...%%...................
m ...............%%%%%...............
m ................%%%%...............
m ..................%................
m ..................%................
m .....%.............................
m .....%.............................
m .......................%%...%%.....
m .............................%%%%%.
m ..............................%%%%.
m ................................%..
m ................................%..
m ...................%...............
m ...................%...............
m ..%%...%%..........................
m ........%%%%%......................
m .........%%%%......................
m ...........%.......................
