rows 30
cols 28
players 2
agents_per_player 1
a 11 0 n 0
a 26 14 n 1
m ..............%%%...........
m ............................
m ............................
m ..............%%%...........
m ..............%.............
m .............%%.............
m ..............%.............
m ..................%%........
m .................%%%........
m ........%..........%%.......
m .......%%...................
m ............................
m ............................
m .............%..............
m .%.........%%%........%%%...
m %%%.........................
m ............................
m ............................
m %%%.........................
m %...........................
m %..........................%
m %...........................
m ....%%......................
m ...%%%......................
m .....%%...............%.....
m .....................%%.....
m ............................
m ............................
m ...........................%
m ........%%%....%.........%%%
