rows 24
cols 30
players 2
agents_per_player 1
a 12 15 n 0
a 0 0 n 1
m ................%%%...........
m ...%%............%............
m .%%%............%%............
m .%.%..........................
m ...%.%%.......................
m ..............................
m ..............................
m ..............................
m ..........%%...%%.............
m ...%.....%%%.%%...............
m ..%%..........%...............
m ..%%..........................
m .%%%..........................
m ..%...............%%..........
m .%%.............%%%...........
m ................%.%...........
m ..................%.%%........
m ..............................
m ..............................
m ..............................
m %%.......................%%...
m ..................%.....%%%.%%
m .................%%..........%
m .................%%...........
