rows 28
cols 28
players 4
agents_per_player 1
a 0 9 n 0
a 21 2 n 1
a 14 23 n 2
a 7 16 n 3
m .....%......................
m ............................
m ............................
m .................%..........
m ................%%..........
m ............................
m ...........%%...............
m ............%...............
m ............................
m ............................
m ........................%...
m .......................%%...
m ............................
m ..................%%........
m ...................%........
m ............................
m ............................
m ...%........................
m ..%%........................
m ............................
m .........................%%.
m ..........................%.
m ............................
m ............................
m ..........%.................
m .........%%.................
m ............................
m ....%%......................
