rows 27
cols 30
players 3
agents_per_player 1
a 6 26 n 0
a 24 6 n 1
a 15 16 n 2
m ..............................
m ..............................
m ..............................
m ...........................%..
m ....................%%%....%..
m .........%..........%.%%......
m .........%.....%..............
m ........%%.....%..%...........
m ........%.........%...........
m ..............................
m ..............................
m ..............................
m .................%............
m ..........%%%....%............
m ..........%.%%...............%
m .....%.......................%
m .....%..%...................%%
m ........%...................%.
m ..............................
m ..............................
m ..............................
m .......%......................
m %%%....%......................
m %.%%...............%..........
m ...................%.....%....
m ..................%%.....%..%.
m ..................%.........%.
