rows 16
cols 18
players 2
agents_per_player 1
a 14 2 n 0
a 6 11 n 1
m ......%.......%...
m ......%...........
m .............%....
m .............%%%..
m ..............%...
m ..................
m ..................
m .....%.........%..
m .....%.........%..
m ...............%..
m ....%.............
m ....%%%...........
m .....%............
m ..................
m ..................
m ......%.......%...
