rows 30
cols 28
players 2
agents_per_player 1
a 0 23 n 0
a 15 9 n 1
m ............................
m .......%....................
m .......%%...................
m .......%%...................
m ........%...%%..............
m ....%%..%...................
m ............................
m .................%..........
m .................%%.........
m ...............%.%%%%.......
m ..............%%%%.%.....%%.
m ...............%%%....%%..%.
m ...............%............
m ............................
m ............................
m ............................
m .....................%......
m .....................%%.....
m .....................%%.....
m ......................%...%%
m ..................%%..%.....
m ............................
m ...%........................
m ...%%.......................
m .%.%%%%.....................
m %%%%.%.....%%...............
m .%%%....%%..%...............
m .%..........................
m ............................
m ............................
