rows 35
cols 30
players 5
agents_per_player 1
a 22 16 n 0
a 1 22 n 1
a 15 28 n 2
a 29 4 n 3
a 8 10 n 4
m .........%.....%%.............
m ........%.....................
m ........%.....................
m .............%................
m .............%................
m ....%........%............%%%.
m ..%%%......................%..
m ...%%......................%..
m ..........................%...
m ..........................%...
m .%............................
m .%............................
m .%............%%%.....%.......
m ...............%....%%%.......
m ...............%.....%%.......
m ..............%...............
m ..............%...............
m ...................%..........
m ...................%..........
m ..%%%.....%........%..........
m ...%....%%%...................
m ...%.....%%...................
m ..%...........................
m ..%...........................
m .......%......................
m .......%......................
m .......%............%%%.....%.
m .....................%....%%%.
m .....................%.....%%.
m ....................%.........
m ....................%.........
m .........................%....
m .........................%....
m ........%%%.....%........%....
m .........%....%%%.............
