rows 20
cols 18
players 2
agents_per_player 1
a 6 12 n 0
a 16 3 n 1
m ..................
m ..................
m ...............%%.
m ................%.
m ..................
m .....%%%..........
m ......%...........
m ..................
m ..................
m ..................
m ..................
m ..................
m ......%%..........
m .......%..........
m ..................
m ..............%%%.
m ...............%..
m ..................
m ..................
m ..................
