rows 28
cols 28
players 4
agents_per_player 1
a 17 7 n 0
a 24 0 n 1
a 3 21 n 2
a 10 14 n 3
m ......................%.....
m ............................
m .........................%..
m .........................%%%
m ............................
m .....%%......%%%............
m ...%%%%.......%%%...........
m ...............%............
m ............................
m ..................%.........
m ..................%%%.......
m ............................
m ......%%%.................%%
m .......%%%..............%%%%
m ........%...................
m ............................
m ...........%................
m ...........%%%..............
m ............................
m %%.................%%......%
m %%%..............%%%%.......
m .%..........................
m ............................
m ....%.......................
m ....%%%.....................
m ............................
m ............%%......%%%.....
m ..........%%%%.......%%%....
