rows 28
cols 28
players 4
agents_per_player 1
a 26 13 n 0
a 19 20 n 1
a 12 27 n 2
a 5 6 n 3
m .................%%.........
m ............................
m .................%......%%..
m .................%..........
m .....................%......
m ....................%%......
m ...........%................
m ..........%%................
m ............................
m ..........%......%%.........
m ..........%.................
m ..............%.............
m .............%%.............
m ....%.......................
m ...%%.......................
m ............................
m ...%......%%................
m ...%........................
m .......%....................
m ......%%....................
m .........................%..
m ........................%%..
m ............................
m ...%%...................%...
m ........................%...
m %...........................
m %..........................%
m ..................%.........
