rows 26
cols 20
players 2
agents_per_player 1
a 11 9 n 0
a 24 19 n 1
m ....................
m ....................
m ....................
m ...............%....
m ..............%%....
m ..............%%....
m ..............%%....
m %....%%........%%.%%
m .....%%.........%%%%
m %.................%%
m ....................
m ....................
m ....................
m ....................
m ....................
m ....................
m .....%..............
m ....%%..............
m ....%%..............
m ....%%..............
m .....%%.%%%....%%...
m ......%%%%.....%%...
m ........%%%.........
m ....................
m ....................
m ....................
