rows 28
cols 30
players 2
agents_per_player 1
a 3 9 n 0
a 17 24 n 1
m ......%%......................
m ..............................
m ..............................
m ...................%%%........
m ...........%%..%....%........%
m ...............%.............%
m ............%%................
m ..............................
m ...........%..................
m ...........%..................
m ..............................
m ...............%%......%%%%%..
m ..............................
m ..............................
m .....................%%.......
m ..............................
m ..............................
m ....%%%.......................
m %....%........%...........%%..
m %.............%...............
m ...........................%%.
m ..............................
m ..........................%...
m ..........................%...
m ..............................
m %%......%%%%%.................
m ..............................
m ..............................
