rows 14
cols 26
players 2
agents_per_player 1
a 7 19 n 0
a 0 6 n 1
m ..........................
m ..........................
m ..........................
m ..........................
m ........%%................
m ..........................
m ...%%.....................
m ..........................
m ..........................
m ..........................
m ..........................
m .....................%%...
m ..........................
m ................%%........
