rows 30
cols 28
players 2
agents_per_player 1
a 18 15 n 0
a 3 1 n 1
m ............................
m ......%%.%%.................
m .......%%%%%................
m ........%%%%................
m ........%%%%................
m ............................
m ............................
m ............................
m ............................
m ............................
m ............................
m ............................
m ............................
m ............................
m ............................
m ............................
m ....................%%.%%...
m .....................%%%%%..
m ......................%%%%..
m ......................%%%%..
m ............................
m ............................
m ............................
m ............................
m ............................
m ............................
m ............................
m ............................
m ............................
m ............................
