rows 24
cols 24
players 2
agents_per_player 1
a 10 11 n 0
a 22 23 n 1
m ...............%%%......
m ................%.......
m ........................
m ..........%%.......%%%..
m ..........%.........%%..
m .....................%..
m ........................
m ........................
m ........................
m .............%..........
m .............%..........
m ...%%........%%.........
m ...%%%..................
m ....%...................
m ........................
m .......%%%............%%
m ........%%............%.
m .........%..............
m ........................
m ........................
m ........................
m .%......................
m .%......................
m .%%............%%.......
