rows 30
cols 30
players 2
agents_per_player 1
a 7 28 n 0
a 22 13 n 1
m ......%.......................
m ..............................
m ..............................
m .%%%.%%.......................
m .%%%..........................
m ..............................
m ..............................
m ....%%........................
m ..............................
m ..............................
m ................%.............
m %...............%%............
m %.............................
m %.%%.................%........
m %...................%%........
m .....................%........
m ..............................
m ..............................
m ................%%%.%%........
m ................%%%...........
m ..............................
m ..............................
m ...................%%.........
m ..............................
m ..............................
m .%............................
m .%%............%..............
m ...............%..............
m ......%........%.%%...........
m .....%%........%..............
