rows 30
cols 28
players 2
agents_per_player 1
a 27 2 n 0
a 12 16 n 1
m ....%......%%%..............
m ...%%.......%...............
m ....%%......................
m .....%......................
m ............................
m ............................
m ............................
m .................%%%........
m ............................
m .................%%.........
m .%..........................
m .%..........................
m ......................%....%
m %....................%%%%.%%
m %....................%.%%%%%
m ..................%......%%%
m .................%%.......%.
m ..................%%........
m ...................%........
m ............................
m ............................
m ............................
m ...%%%......................
m ............................
m ...%%.......................
m ...............%............
m ...............%............
m ........%....%..............
m .......%%%%.%%%.............
m .......%.%%%%%%.............
