rows 30
cols 30
players 5
agents_per_player 1
a 29 14 n 0
a 23 26 n 1
a 17 8 n 2
a 11 20 n 3
a 5 2 n 4
m ................%.............
m .....%........................
m .....%........................
m ..............................
m ....%%%%......................
m ....%%........................
m ....%.........................
m .......................%......
m .......................%......
m ..............................
m ......................%%%%....
m ......................%%......
m ......................%.......
m ...........%..................
m ...........%..................
m ..............................
m ..........%%%%................
m ..........%%..................
m ..........%...................
m .............................%
m .............................%
m ..............................
m %%..........................%%
m ............................%%
m ............................%.
m .................%............
m .................%............
m ..............................
m ................%%%%..........
m ................%%............
