rows 27
cols 21
players 3
agents_per_player 1
a 24 14 n 0
a 15 0 n 1
a 6 7 n 2
m .....................
m .....................
m ..%..................
m .%%.%................
m .%%%%................
m .%%..................
m .....................
m .....................
m .....................
m .....................
m .....................
m ................%....
m ...............%%.%..
m ...............%%%%..
m ...............%%....
m .....................
m .....................
m .....................
m .....................
m .....................
m .........%...........
m ........%%.%.........
m ........%%%%.........
m ........%%...........
m .....................
m .....................
m .....................
