rows 14
cols 28
players 2
agents_per_player 1
a 5 11 n 0
a 12 25 n 1
m .............%..............
m ....%%.......%%.............
m ..............%.............
m ............................
m .......%....................
m .......%....................
m .......%%..................%
m ...........................%
m %.................%%.......%
m %...........................
m ............................
m .....................%......
m .....................%......
m .............%.......%%.....
