rows 28
cols 30
players 2
agents_per_player 1
a 25 19 n 0
a 11 4 n 1
m .........................%%...
m ..............................
m ..............................
m .....%%.......................
m ......%.......................
m ......%%......................
m ......%%...................%..
m ......................%....%..
m ......................%.......
m ..........................%%%.
m ..........................%%%%
m ...................%%.......%.
m ........%%.........%%.........
m ...........%..................
m ..........%%..................
m ..............................
m ..............................
m ....................%%........
m .....................%........
m .....................%%.......
m ............%........%%.......
m .......%....%.................
m .......%......................
m ...........%%%................
m ...........%%%%...............
m ....%%.......%................
m ....%%.................%%.....
m ..........................%...
