rows 36
cols 30
players 6
agents_per_player 1
a 2 25 n 0
a 32 20 n 1
a 26 15 n 2
a 20 10 n 3
a 14 5 n 4
a 8 0 n 5
m ..............................
m ............%.................
m .........%%.%.................
m ............%.................
m ...%%........%%...............
m .............%................
m ..............................
m .................%............
m ..............%%.%............
m .................%............
m ........%%........%%..........
m ..................%...........
m ..............................
m ......................%.......
m ...................%%.%.......
m ......................%.......
m .............%%........%%.....
m .......................%......
m ..............................
m ...........................%..
m ........................%%.%..
m ...........................%..
m ..................%%........%%
m ............................%.
m ..............................
m ..%...........................
m %.%..........................%
m ..%...........................
m ...%%..................%%.....
m ...%..........................
m ..............................
m .......%......................
m ....%%.%......................
m .......%......................
m ........%%..................%%
m ........%.....................
