rows 28
cols 28
players 4
agents_per_player 1
a 20 2 n 0
a 13 9 n 1
a 6 16 n 2
a 27 23 n 3
m ....%%..............%.......
m ....%%..............%.......
m .....%.....%%...............
m ...........%................
m ............................
m ............%%..............
m .............%%.............
m .............%...........%%.
m .............%...........%%.
m ....%%....................%.
m ....%.......................
m ............................
m .....%%.....................
m ......%%....................
m ......%...........%%........
m ......%...........%%........
m ...................%.....%%.
m .........................%..
m ............................
m ..........................%%
m %..........................%
m ...........%%..............%
m ...........%%..............%
m ............%.....%%........
m ..................%.........
m ............................
m ...................%%.......
m ....................%%......
