rows 30
cols 28
players 2
agents_per_player 1
a 4 9 n 0
a 19 23 n 1
m ............................
m ............................
m ........................%%..
m ............................
m ............................
m ............................
m %...................%%.....%
m %%.............%.......%%%.%
m %%.............%.....%...%..
m ...............%.....%......
m %%..%......................%
m ....%...%%%%...............%
m %........%%.................
m %...........................
m %...........................
m ............................
m ............................
m ..........%%................
m ............................
m ............................
m ............................
m ......%%.....%%.............
m .%.......%%%.%%%............
m .%.....%...%..%%............
m .%.....%....................
m .............%%%..%.........
m .............%....%...%%%%..
m ..............%........%%...
m ..............%.............
m ..............%.............
