rows 28
cols 28
players 4
agents_per_player 1
a 26 3 n 0
a 5 10 n 1
a 12 17 n 2
a 19 24 n 3
m ............%%%%............
m .....%%.............%%%.....
m .....................%......
m ............................
m .......................%%%..
m ...................%%.......
m ...................%%.......
m ...................%%%%.....
m %%..........%%.............%
m %...........................
m ............................
m ..%%%.......................
m ..........................%%
m ..........................%%
m %%........................%%
m ......%%%..........%%.......
m .......%....................
m ............................
m .........%%%................
m .....%%.....................
m .....%%.....................
m .....%%%%...................
m .............%%%..........%%
m ..............%.............
m ............................
m ................%%%.........
m ............%%..............
m ............%%..............
