rows 30
cols 30
players 2
agents_per_player 1
a 21 13 n 0
a 6 28 n 1
m ..............................
m ..............................
m .............%%...............
m ...........%%.%%..............
m .....................%%%......
m .......................%......
m .................%%...........
m ..............................
m ..............................
m ..............................
m ........................%.....
m ........................%%....
m ........................%.....
m ..............................
m ..............................
m ..............................
m ..............................
m ............................%%
m %.........................%%.%
m ......%%%.....................
m ........%.....................
m ..%%..........................
m ..............................
m ..............................
m ..............................
m .........%....................
m .........%%...................
m .........%....................
m ..............................
m ..............................
