rows 36
cols 42
players 6
agents_per_player 1
a 26 12 n 0
a 32 19 n 1
a 2 26 n 2
a 8 33 n 3
a 14 40 n 4
a 20 5 n 5
m .................................%%.......
m .................................%........
m ..........................................
m ..............................%%%.........
m ..............................%%%.........
m ..........................................
m ........................................%%
m ........................................%.
m ..........................................
m .....................................%%%..
m .....................................%%%..
m ..........................................
m .....%%...................................
m .....%....................................
m ..........................................
m ..%%%.....................................
m ..%%%.....................................
m ..........................................
m ............%%............................
m ............%.............................
m ..........................................
m .........%%%..............................
m .........%%%..............................
m ..........................................
m ...................%%.....................
m ...................%......................
m ..........................................
m ................%%%.......................
m ................%%%.......................
m ..........................................
m ..........................%%..............
m ..........................%...............
m ..........................................
m .......................%%%................
m .......................%%%................
m ..........................................
