rows 30
cols 30
players 5
agents_per_player 1
a 1 25 n 0
a 13 19 n 1
a 25 13 n 2
a 7 7 n 3
a 19 1 n 4
m ..............................
m ..............................
m ..........%%%.................
m .......%%.%%..........%.......
m ......................%%......
m ...%%.........................
m ..............................
m ..............................
m ......................%%%.....
m ....%..............%%.%%......
m ....%%........................
m ...............%%.............
m ..............................
m ..............................
m ....%%%.......................
m .%%.%%..........%.............
m ................%%............
m ...........................%%.
m ..............................
m ..............................
m ................%%%...........
m .............%%.%%..........%.
m ............................%%
m .........%%...................
m ..............................
m ..............................
m %...........................%%
m ..........%..............%%.%%
m ..........%%..................
m .....................%%.......
