rows 70
cols 70
players 10
agents_per_player 1
a 66 62 n 0
a 59 55 n 1
a 52 48 n 2
a 45 41 n 3
a 38 34 n 4
a 31 27 n 5
a 24 20 n 6
a 17 13 n 7
a 10 6 n 8
a 3 69 n 9
m .....................%%..........................%%...................
m .............................................%%...%..%................
m .................................................%%%.%%%..............
m .................................................%%%%%.%..............
m .................................................%%...................
m ..................................................%...................
m ............................%%..........................%.............
m ............................%%..........................%%............
m ....................................................%%...%..%.........
m ........................................................%%%.%%%.......
m ........................................................%%%%%.%.......
m ........................................................%%............
m .........................................................%............
m ...................................%%..........................%......
m ...................................%%..........................%%.....
m ...........................................................%%...%..%..
m ...............................................................%%%.%%%
m ...............................................................%%%%%.%
m ...............................................................%%.....
m ................................................................%.....
m %.........................................%%..........................
m %%........................................%%..........................
m .%..%.............................................................%%..
m %%%.%%%...............................................................
m %%%%%.%...............................................................
m %%....................................................................
m .%....................................................................
m .......%.........................................%%...................
m .......%%........................................%%...................
m ...%%...%..%..........................................................
m .......%%%.%%%........................................................
m .......%%%%%.%........................................................
m .......%%.............................................................
m ........%.............................................................
m ..............%.........................................%%............
m ..............%%........................................%%............
m ..........%%...%..%...................................................
m ..............%%%.%%%.................................................
m ..............%%%%%.%.................................................
m ..............%%......................................................
m ...............%......................................................
m .....................%.........................................%%.....
m .....................%%........................................%%.....
m .................%%...%..%............................................
m .....................%%%.%%%..........................................
m .....................%%%%%.%..........................................
m .....................%%...............................................
m ......................%...............................................
m %%..........................%.........................................
m %%..........................%%........................................
m ........................%%...%..%.....................................
m ............................%%%.%%%...................................
m ............................%%%%%.%...................................
m ............................%%........................................
m .............................%........................................
m .......%%..........................%..................................
m .......%%..........................%%.................................
m ...............................%%...%..%..............................
m ...................................%%%.%%%............................
m ...................................%%%%%.%............................
m ...................................%%.................................
m ....................................%.................................
m ..............%%..........................%...........................
m ..............%%..........................%%..........................
m ......................................%%...%..%.......................
m ..........................................%%%.%%%.....................
m ..........................................%%%%%.%.....................
m ..........................................%%..........................
m ...........................................%..........................
m .....................%%..........................%....................
