rows 30
cols 30
players 5
agents_per_player 1
a 6 23 n 0
a 0 17 n 1
a 24 11 n 2
a 18 5 n 3
a 12 29 n 4
m ..................%...........
m ...................%..........
m ...................%...%%.....
m .......................%......
m %........................%%%%%
m ........................%%.%%.
m ........................%.....
m .........................%....
m %........................%...%
m .............................%
m .%%%%%%.......................
m %%.%%.........................
m %.............................
m .%............................
m .%...%%.......................
m .....%........................
m .......%%%%%%.................
m ......%%.%%...................
m ......%.......................
m .......%......................
m .......%...%%.................
m ...........%..................
m .............%%%%%%...........
m ............%%.%%.............
m ............%.................
m .............%................
m .............%...%%...........
m .................%............
m ...................%%%%%%.....
m ..................%%.%%.......
