rows 30
cols 28
players 2
agents_per_player 1
a 22 17 n 0
a 7 3 n 1
m .....%......................
m ............................
m ................%%%%........
m ............................
m .%%.........................
m ............................
m ...............%............
m ...............%............
m ...............%............
m ...%........................
m ...%........................
m .%%%........................
m .%%%........................
m ............................
m ...................%........
m ...................%........
m ............................
m ..%%%%......................
m ............................
m ...............%%...........
m ............................
m .%..........................
m .%..........................
m .%..........................
m .................%..........
m .................%..........
m ...............%%%..........
m ...............%%%..........
m ............................
m .....%......................
