rows 28
cols 30
players 2
agents_per_player 1
a 9 13 n 0
a 23 28 n 1
m ...........................%..
m ..........................%%..
m ..........................%%..
m ...........................%%.
m ........................%%....
m ...........................%%%
m ............................%.
m ..............................
m ..............................
m ..............................
m ..............................
m ..............................
m ..................%%..........
m ............%.................
m ............%.................
m ...........%%.................
m ...........%%.................
m ............%%................
m .........%%...................
m ............%%%...............
m .............%................
m ..............................
m ..............................
m ..............................
m ..............................
m ..............................
m ...%%.........................
m ...........................%..
