rows 14
cols 26
players 2
agents_per_player 1
a 2 14 n 0
a 9 1 n 1
m ...........%%%%...........
m ..........................
m ..........................
m ..........................
m ..%.......................
m ..%...............%%......
m .%%......................%
m %%......................%%
m ..........................
m ..........................
m ..........................
m ...............%..........
m .....%%........%..........
m ............%.%%..........
