rows 24
cols 30
players 3
agents_per_player 1
a 16 10 n 0
a 0 20 n 1
a 8 0 n 2
m ....%.........................
m ..............................
m ..............................
m .%%%..........................
m ..%...........................
m %%%...........................
m .%%...........................
m ..............%...............
m ..............%...............
m ..............................
m ..............................
m ...........%%%................
m ............%.................
m ..........%%%.................
m ...........%%.................
m ........................%.....
m ........................%.....
m ..............................
m ..............................
m .....................%%%......
m ......................%.......
m ....................%%%.......
m .....................%%.......
m ....%.........................
