rows 30
cols 28
players 2
agents_per_player 1
a 2 12 n 0
a 17 26 n 1
m ....%%......................
m ....%%......................
m ...%%.......................
m %%..........................
m ............................
m ............................
m ............................
m ............................
m ............................
m ........%%..................
m .................%%.........
m ................%%%.........
m .%%...............%.........
m .%..........................
m ............................
m ..................%%........
m ..................%%........
m .................%%.........
m ..............%%............
m ............................
m ............................
m ............................
m ............................
m ............................
m ......................%%....
m ...%%.......................
m ..%%%.......................
m ....%..........%%...........
m ...............%............
m ............................
