rows 30
cols 30
players 5
agents_per_player 1
a 25 5 n 0
a 19 23 n 1
a 13 11 n 2
a 7 29 n 3
a 1 17 n 4
m %.............................
m %%......................%.....
m .%.........%............%.....
m ...........%..................
m ..%...........................
m .%%.........%.................
m ............%.................
m ......%.....%%................
m ......%......%.........%......
m .......................%......
m ..............%...............
m .............%%.........%.....
m ........................%.....
m ..................%.....%%....
m .....%............%......%....
m .....%........................
m ..........................%...
m ......%..................%%...
m ......%.......................
m %.....%%......................
m %......%.........%............
m .................%............
m ........%.....................
m .......%%.........%...........
m ..................%...........
m ............%.....%%..........
m ............%......%.........%
m .............................%
m ....................%.........
m %..................%%.........
