rows 30
cols 30
players 2
agents_per_player 1
a 25 12 n 0
a 10 27 n 1
m .................%......%%%%..
m .........................%%%..
m ...............%%.......%%%...
m ........................%.....
m ........................%%....
m ..................%...........
m ..................%...........
m ..............................
m .........%%...................
m .........%%...................
m .........%%...................
m .........%....................
m .......%%%%...................
m ........%%%...................
m %%%.......%%%.................
m ..%......%%%%.................
m ..........%%%.................
m %%.......%%%..................
m .........%....................
m .........%%...................
m ...%..........................
m ...%..........................
m ..............................
m ........................%%....
m ........................%%....
m ........................%%....
m ........................%.....
m ......................%%%%....
m .......................%%%....
m ...............%%%.......%%%..
