rows 70
cols 70
players 10
agents_per_player 1
a 26 68 n 0
a 47 5 n 1
a 68 12 n 2
a 19 19 n 3
a 40 26 n 4
a 61 33 n 5
a 12 40 n 6
a 33 47 n 7
a 54 54 n 8
a 5 61 n 9
m ........................................%%%...........................
m .......................................%%%%.......%%..................
m .......................................%...........%.......%%.........
m ...%%%.................................%%%.........%..................
m %%.%%%....................%%%............%%...........................
m ............................%.........%%.%%...........................
m ......................................%...............................
m ...................%%%................................................
m ..................%%%%.......%%.......................................
m ..................%...........%.......%%..............................
m ..................%%%.........%.....................%%%...............
m .....%%%............%%...........................%%.%%%...............
m .......%.........%%.%%................................................
m .................%....................................................
m %...................................................................%%
m %.......%%.........................................................%%%
m .........%.......%%................................................%..
m .........%.....................%%%.................................%%%
m %...........................%%.%%%....................%%%............%
m %.......................................................%.........%%.%
m ..................................................................%...
m ...............................................%%%....................
m ..............................................%%%%.......%%...........
m ..............................................%...........%.......%%..
m ..........%%%.................................%%%.........%...........
m .......%%.%%%....................%%%............%%....................
m ...................................%.........%%.%%....................
m .............................................%........................
m ..........................%%%.........................................
m .........................%%%%.......%%................................
m .........................%...........%.......%%.......................
m .........................%%%.........%.....................%%%........
m ............%%%............%%...........................%%.%%%........
m ..............%.........%%.%%.........................................
m ........................%.............................................
m .....%%%..............................................................
m ....%%%%.......%%.....................................................
m ....%...........%.......%%............................................
m ....%%%.........%.....................%%%.............................
m ......%%...........................%%.%%%....................%%%......
m ...%%.%%.......................................................%......
m ...%..................................................................
m ......................................................%%%.............
m .....................................................%%%%.......%%....
m ...%%................................................%...........%....
m .................%%%.................................%%%.........%....
m ..............%%.%%%....................%%%............%%.............
m ..........................................%.........%%.%%.............
m ....................................................%.................
m .................................%%%..................................
m ................................%%%%.......%%.........................
m ................................%...........%.......%%................
m ................................%%%.........%.....................%%%.
m ...................%%%............%%...........................%%.%%%.
m .....................%.........%%.%%..................................
m ...............................%......................................
m ............%%%.......................................................
m ...........%%%%.......%%..............................................
m ...........%...........%.......%%.....................................
m ...........%%%.........%.....................%%%......................
m %............%%...........................%%.%%%....................%%
m %.........%%.%%.......................................................
m ..........%...........................................................
m .............................................................%%%......
m .%%.........................................................%%%%......
m ..%.......%%................................................%.........
m ..%.....................%%%.................................%%%.......
m .....................%%.%%%....................%%%............%%......
m .................................................%.........%%.%%......
m ...........................................................%..........
