rows 30
cols 30
players 2
agents_per_player 1
a 1 2 n 0
a 16 17 n 1
m .....%........................
m ..............................
m ..............................
m ..............................
m ..............................
m ..............................
m ..............................
m ......................%.......
m .............%........%%%%....
m .............%%......%%%......
m ......................%%......
m ..............%%......%.......
m ...............%%.............
m .........%%%..............%%%.
m ....................%.........
m ....................%.........
m ..............................
m ..............................
m ..............................
m ..............................
m ..............................
m ..............................
m .......%......................
m .......%%%%.................%.
m ......%%%...................%%
m .......%%.....................
m %......%.....................%
m %%............................
m ...........%%%..........%%%...
m .....%........................
