rows 26
cols 20
players 2
agents_per_player 1
a 22 12 n 0
a 9 2 n 1
m ....................
m ....................
m ....................
m ....................
m ....................
m .%%%............%%..
m .%%%................
m %%.................%
m %...................
m ....................
m ....................
m ....................
m ....................
m ....................
m ....................
m ....................
m ....................
m ....................
m ......%%...%%%......
m ...........%%%......
m .........%%%........
m ..........%.........
m ....................
m ....................
m ....................
m ....................
