rows 30
cols 30
players 5
agents_per_player 1
a 18 9 n 0
a 12 27 n 1
a 6 15 n 2
a 0 3 n 3
a 24 21 n 4
m ..............................
m ..............................
m ...........%%.................
m ...........%..%...............
m ..............%...............
m ..............................
m ..............................
m ..............................
m .......................%%.....
m .......................%..%...
m ..........................%...
m ..............................
m ..............................
m ..............................
m .....%%.......................
m .....%..%.....................
m ........%.....................
m ..............................
m ..............................
m ..............................
m .................%%...........
m .................%..%.........
m ....................%.........
m ..............................
m ..............................
m ..............................
m %............................%
m ..%..........................%
m ..%...........................
m ..............................
