rows 42
cols 42
players 6
agents_per_player 1
a 17 18 n 0
a 10 11 n 1
a 3 4 n 2
a 38 39 n 3
a 31 32 n 4
a 24 25 n 5
m ......................%............%%.....
m ......................%.............%.....
m ...............%.%%...%%..................
m ...............%%.........................
m .......................%%%%...............
m .......................%%.................
m .%%.......................................
m %%...........................%............
m .%...........................%............
m ......................%.%%...%%...........
m ......................%%..................
m ..............................%%%%........
m ..............................%%..........
m ........%%................................
m .......%%...........................%.....
m ........%...........................%.....
m .............................%.%%...%%....
m .............................%%...........
m .....................................%%%%.
m .....................................%%...
m ...............%%.........................
m .%............%%..........................
m .%.............%..........................
m .%%.................................%.%%..
m ....................................%%....
m ..%%%%....................................
m ..%%......................................
m ......................%%..................
m ........%............%%...................
m ........%.............%...................
m .%.%%...%%................................
m .%%.......................................
m .........%%%%.............................
m .........%%...............................
m .............................%%...........
m ...............%............%%............
m ...............%.............%............
m ........%.%%...%%.........................
m ........%%................................
m ................%%%%......................
m ................%%........................
m ....................................%%....
