rows 28
cols 30
players 2
agents_per_player 1
a 14 11 n 0
a 0 26 n 1
m .%............................
m .%............................
m .............%%...............
m ..............%...............
m ........%.....................
m %......%%%%.................%%
m .........%....................
m .........%....................
m ......................%.......
m ......................%.......
m ..............................
m ..............................
m ..........%%..................
m ...........%%.................
m ................%.............
m ................%.............
m ............................%%
m .............................%
m .......................%......
m .............%%%......%%%%....
m ........................%.....
m ........................%.....
m .......%......................
m .......%......................
m ..............................
m ..............................
m .........................%%...
m ..........................%%..
