rows 30
cols 36
players 6
agents_per_player 1
a 22 5 n 0
a 17 11 n 1
a 12 17 n 2
a 7 23 n 3
a 2 29 n 4
a 27 35 n 5
m ....................................
m ................%%..................
m ............%%%.....................
m .............%......................
m .............%......................
m ....................................
m ..........%%........................
m ......%%%...........................
m .......%............................
m .......%............................
m ....................................
m ....%%..............................
m %%%.................................
m .%..................................
m .%..................................
m ....................................
m ..................................%%
m ..............................%%%...
m ...............................%....
m ...............................%....
m ....................................
m ............................%%......
m ........................%%%.........
m .........................%..........
m .........................%..........
m ....................................
m ......................%%............
m ..................%%%...............
m ...................%................
m ...................%................
