rows 70
cols 70
players 10
agents_per_player 1
a 57 33 n 0
a 50 12 n 1
a 43 61 n 2
a 36 40 n 3
a 29 19 n 4
a 22 68 n 5
a 15 47 n 6
a 8 26 n 7
a 1 5 n 8
a 64 54 n 9
m ...........%%...%%%....%%.........................................%%%.
m .................%%....%..............................................
m ................%.....................................................
m ...............%%................%%..................%................
m .....................................................%................
m ......................................................................
m ..........................................%%%%%.......................
m .................%%%............%%...%%%....%%........................
m ......................................%%....%.........................
m .....................................%................................
m ....%...............................%%................%%..............
m ....%.................................................................
m ......................................................................
m ...............................................................%%%%%..
m ......................................%%%............%%...%%%....%%...
m ...........................................................%%....%....
m ..........................................................%...........
m .....%%..................%...............................%%...........
m .........................%............................................
m ......................................................................
m ..............%%%%%...................................................
m ....%%...%%%....%%.........................................%%%........
m ..........%%....%.....................................................
m .........%............................................................
m ........%%................%%..................%.......................
m ..............................................%.......................
m ......................................................................
m ...................................%%%%%..............................
m ..........%%%............%%...%%%....%%...............................
m ...............................%%....%................................
m ..............................%.......................................
m .............................%%................%%..................%..
m ...................................................................%..
m ......................................................................
m ........................................................%%%%%.........
m ...............................%%%............%%...%%%....%%..........
m ....................................................%%....%...........
m ...................................................%..................
m ..................%...............................%%................%%
m ..................%...................................................
m ......................................................................
m .......%%%%%..........................................................
m ..%%%....%%.........................................%%%............%%.
m ...%%....%............................................................
m ..%...................................................................
m .%%................%%..................%..............................
m .......................................%..............................
m ......................................................................
m ............................%%%%%.....................................
m ...%%%............%%...%%%....%%......................................
m ........................%%....%.......................................
m .......................%..............................................
m ......................%%................%%..................%.........
m ............................................................%.........
m ......................................................................
m .................................................%%%%%................
m ........................%%%............%%...%%%....%%.................
m .............................................%%....%..................
m ............................................%.........................
m ...........%...............................%%................%%.......
m ...........%..........................................................
m ......................................................................
m %%%%%.................................................................
m ..%%.........................................%%%............%%...%%%..
m ..%...............................................................%%..
m .................................................................%....
m ............%%..................%...............................%%....
m ................................%.....................................
m ......................................................................
m .....................%%%%%............................................
