rows 45
cols 54
players 9
agents_per_player 1
a 23 7 n 0
a 33 13 n 1
a 43 19 n 2
a 8 25 n 3
a 18 31 n 4
a 28 37 n 5
a 38 43 n 6
a 3 49 n 7
a 13 1 n 8
m ...............%%.....................................
m ..................................................%...
m ..................................................%%..
m ..................................................%%..
m ..............................................%%......
m .............................................%%.......
m ..........................%...........................
m ..........................%%..........................
m ..........................%%..........................
m ......................%%..............................
m .....................%%...............................
m ..%...................................................
m ..%%..................................................
m ..%%..................................................
m ....................................................%%
m ...................................................%%.
m ................................%.....................
m ................................%%....................
m ................................%%....................
m ............................%%........................
m ...........................%%.........................
m ........%.............................................
m ........%%............................................
m ........%%............................................
m ....%%................................................
m ...%%.................................................
m ......................................%...............
m ......................................%%..............
m ......................................%%..............
m ..................................%%..................
m .................................%%...................
m ..............%.......................................
m ..............%%......................................
m ..............%%......................................
m ..........%%..........................................
m .........%%...........................................
m ............................................%.........
m ............................................%%........
m ............................................%%........
m ........................................%%............
m .......................................%%.............
m ....................%.................................
m ....................%%................................
m ....................%%................................
m ................%%....................................
