rows 28
cols 30
players 2
agents_per_player 1
a 14 12 n 0
a 0 27 n 1
m .......................%......
m ..........%%...........%......
m ..............................
m ..............................
m .....................%%.......
m ......................%.......
m ......................%.......
m ..............................
m .%%......%%%..................
m .%.......%.%.%................
m ...........%.%%............%..
m ............%%%............%%%
m ............%%................
m .............%................
m ........%.....................
m ........%................%%...
m ..............................
m ..............................
m ......%%......................
m .......%......................
m .......%......................
m ..............................
m ................%%......%%%...
m ................%.......%.%.%.
m ............%.............%.%%
m ............%%%............%%%
m ...........................%%.
m ............................%.
