rows 63
cols 54
players 9
agents_per_player 1
a 45 9 n 0
a 31 51 n 1
a 17 39 n 2
a 3 27 n 3
a 52 15 n 4
a 38 3 n 5
a 24 45 n 6
a 10 33 n 7
a 59 21 n 8
m ...........%....%%....................%.....%%.%%%%%..
m ................%%....................%.........%%....
m ................%.....................................
m ............%%........................................
m ......................................................
m ................%%....................................
m %%%%............%%..........................%......%..
m %%%%.............%....%%....................%.....%%.%
m %%....................%%....................%.........
m ......................%...............................
m ..................%%..................................
m ......................................................
m ......................%%..............................
m ...%..%%%%............%%..........................%...
m ..%%.%%%%%.............%....%%....................%...
m ......%%....................%%....................%...
m ............................%.........................
m ........................%%............................
m ......................................................
m ............................%%........................
m ..%......%..%%%%............%%........................
m ..%.....%%.%%%%%.............%....%%..................
m ..%.........%%....................%%..................
m ..................................%...................
m ..............................%%......................
m ......................................................
m ..................................%%..................
m ........%......%..%%%%............%%..................
m ........%.....%%.%%%%%.............%....%%............
m ........%.........%%....................%%............
m ........................................%.............
m ....................................%%................
m ......................................................
m ........................................%%............
m ..............%......%..%%%%............%%............
m ..............%.....%%.%%%%%.............%....%%......
m ..............%.........%%....................%%......
m ..............................................%.......
m ..........................................%%..........
m ......................................................
m ..............................................%%......
m ....................%......%..%%%%............%%......
m ....................%.....%%.%%%%%.............%....%%
m ....................%.........%%....................%%
m ....................................................%.
m ................................................%%....
m ......................................................
m ....................................................%%
m ..........................%......%..%%%%............%%
m ....%%....................%.....%%.%%%%%.............%
m ....%%....................%.........%%................
m ....%.................................................
m %%....................................................
m ......................................................
m ....%%................................................
m ....%%..........................%......%..%%%%........
m .....%....%%....................%.....%%.%%%%%........
m ..........%%....................%.........%%..........
m ..........%...........................................
m ......%%..............................................
m ......................................................
m ..........%%..........................................
m ..........%%..........................%......%..%%%%..
