rows 35
cols 35
players 5
agents_per_player 1
a 19 12 n 0
a 33 5 n 1
a 12 33 n 2
a 26 26 n 3
a 5 19 n 4
m ...................................
m ...................................
m .........%.........................
m .........%%........................
m ...................................
m ...................................
m ...................................
m ...................................
m ...................................
m .......................%...........
m .......................%%..........
m ...................................
m ...................................
m ...................................
m ...................................
m ...................................
m ..%................................
m ..%%...............................
m ...................................
m ...................................
m ...................................
m ...................................
m ...................................
m ................%..................
m ................%%.................
m ...................................
m ...................................
m ...................................
m ...................................
m ...................................
m ..............................%....
m ..............................%%...
m ...................................
m ...................................
m ...................................
