rows 27
cols 30
players 3
agents_per_player 1
a 13 1 n 0
a 22 21 n 1
a 4 11 n 2
m ..............................
m ................%%............
m ..............................
m ..............................
m %............................%
m %...........%.%%.............%
m ............%...%%............
m .........%....................
m .........%....................
m ..............................
m ......%%......................
m ..............................
m ..............................
m ...................%%.........
m ..%.%%.............%%.........
m ..%...%%......................
m .............................%
m .............................%
m ..............................
m ..........................%%..
m ..............................
m ..............................
m .........%%...................
m .........%%...........%.%%....
m ......................%...%%..
m ...................%..........
m ...................%..........
