rows 18
cols 20
players 2
agents_per_player 1
a 15 6 n 0
a 6 16 n 1
m ...................%
m ....................
m ....................
m ....................
m ...%........%%......
m ...%.......%%%......
m ..%..%%%.....%......
m ..%.................
m ....%%...%..........
m .........%..........
m ....................
m ....................
m ....................
m ..%%.........%......
m .%%%.........%......
m ...%........%..%%%..
m ............%.......
m ..............%%...%
