rows 27
cols 24
players 3
agents_per_player 1
a 23 19 n 0
a 14 11 n 1
a 5 3 n 2
m ..............%.........
m ........................
m ........................
m .%%%....................
m ........................
m ........................
m ......................%.
m .....................%%.
m .....................%%%
m ......................%.
m ........................
m ........................
m .........%%%............
m ........................
m ........................
m ......%.................
m .....%%.................
m .....%%%................
m ......%.................
m ........................
m ........................
m .................%%%....
m ........................
m ........................
m ..............%.........
m .............%%.........
m .............%%%........
