rows 28
cols 30
players 2
agents_per_player 1
a 18 23 n 0
a 4 8 n 1
m ..............................
m ..............................
m ..............................
m ..............................
m ...%..........................
m %..%..........................
m %%..%%........................
m %.%.%.........................
m ..%.%%........................
m %...%.........................
m %.............................
m ........%%....................
m ........%%....................
m ........%%....................
m ..............................
m ..............................
m ..............................
m ..............................
m ..................%...........
m ...............%..%...........
m ...............%%..%%.........
m ...............%.%.%..........
m .................%.%%.........
m ...............%...%..........
m ...............%..............
m .......................%%.....
m .......................%%.....
m .......................%%.....
