rows 30
cols 30
players 2
agents_per_player 1
a 5 22 n 0
a 20 7 n 1
m ..............................
m ..............................
m .....%%%......................
m ...%%%%.......................
m ...%%.........................
m ......%.......................
m ......%%......................
m ......%%%.....................
m ......%%%...%.................
m ......%%%...%%%...............
m ..............................
m ..............................
m ..............................
m ..............................
m ..............................
m ..............................
m ..............................
m ....................%%%.......
m ..................%%%%........
m ..................%%..........
m .....................%........
m .....................%%.......
m .....................%%%......
m .....................%%%...%..
m .....................%%%...%%%
m ..............................
m ..............................
m ..............................
m ..............................
m ..............................
