rows 35
cols 35
players 5
agents_per_player 1
a 12 29 n 0
a 5 22 n 1
a 33 15 n 2
a 26 8 n 3
a 19 1 n 4
m ...................................
m %.................................%
m %.................................%
m ...................................
m ...................................
m ......%............%...............
m ......%...........%%...............
m ...................................
m ......%%...........................
m ......%%...........................
m ...................................
m ...................................
m .............%............%........
m .............%...........%%........
m ...................................
m .............%%....................
m .............%%....................
m ...................................
m ...................................
m ....................%............%.
m ....................%...........%%.
m ...................................
m ....................%%.............
m ....................%%.............
m ...................................
m ...................................
m .....%.....................%.......
m ....%%.....................%.......
m ...................................
m ...........................%%......
m ...........................%%......
m ...................................
m ...................................
m ............%.....................%
m ...........%%.....................%
