rows 28
cols 28
players 4
agents_per_player 1
a 10 5 n 0
a 3 12 n 1
a 24 19 n 2
a 17 26 n 3
m ........%%%%................
m ............................
m .....%.............%%.......
m .....%......................
m .......%%...%...............
m ............%...............
m ............%...............
m .%%%%.......................
m ............................
m ............%%............%.
m ..........................%.
m %%...%......................
m .....%......................
m .....%......................
m ......................%%%%..
m ............................
m .....%%............%........
m ...................%........
m .....................%%...%.
m ..........................%.
m ..........................%.
m ...............%%%%.........
m ............................
m ............%.............%%
m ............%...............
m ..............%%...%........
m ...................%........
m ...................%........
