rows 30
cols 30
players 3
agents_per_player 1
a 21 14 n 0
a 1 24 n 1
a 11 4 n 2
m .....................%%.......
m .....................%.....%%.
m ..........................%%%.
m ...........................%%.
m ..............................
m ......%%......%%..............
m .......%...%...%..............
m .........%.%..................
m ........%%.%..................
m ...........%..................
m .%%...........................
m .%.....%%.....................
m ......%%%.....................
m .......%%.....................
m ..............................
m ................%%......%%....
m .................%...%...%....
m ...................%.%........
m ..................%%.%........
m .....................%........
m ...........%%.................
m ...........%.....%%...........
m ................%%%...........
m .................%%...........
m ..............................
m ....%%....................%%..
m .%...%.....................%..
m .%...........................%
m .%..........................%%
m .%............................
