rows 35
cols 35
players 5
agents_per_player 1
a 14 16 n 0
a 21 9 n 1
a 28 2 n 2
a 0 30 n 3
a 7 23 n 4
m %..................................
m %............%.....................
m %..........%%%.....................
m %..........%%%.....................
m %%.................................
m ...................................
m ...................................
m ............................%......
m ......%.....................%......
m ....%%%.....................%......
m ....%%%.....................%......
m ............................%%.....
m ...................................
m ...................................
m .....................%.............
m .....................%............%
m .....................%..........%%%
m .....................%..........%%%
m .....................%%............
m ...................................
m ...................................
m ..............%....................
m ..............%............%.......
m ..............%..........%%%.......
m ..............%..........%%%.......
m ..............%%...................
m ...................................
m ...................................
m .......%...........................
m .......%............%..............
m .......%..........%%%..............
m .......%..........%%%..............
m .......%%..........................
m ...................................
m ...................................
