rows 30
cols 35
players 5
agents_per_player 1
a 9 24 n 0
a 21 10 n 1
a 3 31 n 2
a 15 17 n 3
a 27 3 n 4
m ...................................
m ........................%..........
m ...%%...................%..........
m ....%%.............................
m .......................%..%........
m .......................%..%........
m ...................................
m .................%.................
m .................%.............%%..
m ................................%%.
m ................%..%...............
m ................%..%...............
m ...................................
m ..........%........................
m ..........%.............%%.........
m .........................%%........
m .........%..%......................
m .........%..%......................
m ...................................
m ...%...............................
m ...%.............%%................
m ..................%%...............
m ..%..%.............................
m ..%..%.............................
m ...................................
m ...............................%...
m ..........%%...................%...
m ...........%%......................
m ..............................%..%.
m ..............................%..%.
