rows 30
cols 30
players 2
agents_per_player 1
a 2 27 n 0
a 17 12 n 1
m .......%.%%...................
m ......%%%....%%..........%....
m ........................%%....
m ..............................
m ..............................
m ....................%%........
m .....................%.%......
m ....%.................%%%.....
m ....%.........................
m ..............................
m ..............................
m .................%%..........%
m ...%%..........%%%%..........%
m ................%%%...........
m ..............................
m ......................%.%%....
m ..........%..........%%%....%%
m .........%%...................
m ..............................
m ..............................
m .....%%.......................
m ......%.%.....................
m .......%%%.........%..........
m ...................%..........
m ..............................
m ..............................
m ..%%..........%...............
m %%%%..........%...%%..........
m .%%%..........................
m ..............................
