rows 36
cols 30
players 6
agents_per_player 1
a 26 18 n 0
a 32 13 n 1
a 2 8 n 2
a 8 3 n 3
a 14 28 n 4
a 20 23 n 5
m ..............................
m .....%......................%%
m .....%%.......................
m ..............................
m ..............................
m ..............................
m ..............................
m %......................%%.....
m %%............................
m ..............................
m ..............................
m ..............................
m ..............................
m ..................%%.....%....
m .........................%%...
m ..............................
m ..............................
m ..............................
m ..............................
m .............%%.....%.........
m ....................%%........
m ..............................
m ..............................
m ..............................
m ..............................
m ........%%.....%..............
m ...............%%.............
m ..............................
m ..............................
m ..............................
m ..............................
m ...%%.....%...................
m ..........%%..................
m ..............................
m ..............................
m ..............................
