rows 28
cols 28
players 4
agents_per_player 1
a 1 19 n 0
a 8 12 n 1
a 15 5 n 2
a 22 26 n 3
m ...........%...........%....
m ...........%%...............
m ............................
m .........................%..
m ........................%%..
m ........................%...
m ....%...........%.........%%
m ....%...........%...........
m ....%%......................
m ............................
m ..................%.........
m .................%%.........
m .................%..........
m .........%.........%%....%..
m .........%...............%..
m .........................%%.
m ............................
m ...........%................
m ..........%%................
m ..........%.................
m ..%.........%%....%.........
m ..%...............%.........
m ..................%%........
m ............................
m ....%.......................
m ...%%.......................
m ...%........................
m .....%%....%...........%....
