rows 30
cols 28
players 2
agents_per_player 1
a 10 8 n 0
a 25 22 n 1
m ............................
m ............................
m ............................
m ............%...............
m ............%%%.............
m ................%%..........
m ..............%%%%..........
m ...............%%%..........
m ...............%............
m ............................
m ............................
m ............................
m ............................
m %%..........................
m ............................
m ............................
m ............................
m ............................
m ..........................%.
m %.........................%%
m ..%%........................
m %%%%........................
m .%%%........................
m .%..........................
m ............................
m ............................
m ............................
m ............................
m ..............%%............
m ............................
