rows 16
cols 26
players 2
agents_per_player 1
a 1 9 n 0
a 9 22 n 1
m ..........................
m ..........................
m .......................%..
m .................%%..%%%..
m .................%%.%%....
m ..................%.......
m ..........................
m ..........................
m ..........................
m ..........................
m ..........%...............
m ....%%..%%%...............
m ....%%.%%.................
m .....%....................
m ..........................
m ..........................
