rows 28
cols 30
players 2
agents_per_player 1
a 7 14 n 0
a 21 29 n 1
m ...........%..................
m .........%.%..................
m ........%%%%..................
m ..............................
m ......%.......................
m .....%%%......................
m ......%.......................
m ..............................
m ..............................
m ..............................
m ..............................
m ..............................
m ..............................
m ..............................
m ..........................%...
m ........................%.%...
m .......................%%%%...
m ..............................
m .....................%........
m ....................%%%.......
m .....................%........
m ..............................
m ..............................
m ..............................
m ..............................
m ..............................
m ..............................
m ..............................
