rows 30
cols 28
players 2
agents_per_player 1
a 14 11 n 0
a 29 25 n 1
m ............................
m ............................
m ........................%%..
m ............................
m ............................
m ......%%%%..................
m ......%%%.....%%............
m .......%....................
m .......%....................
m ............................
m ....%.......................
m ....%.......................
m ....%%..%%..................
m .........%..................
m .........%..................
m ............................
m ............................
m ..........%%................
m ............................
m ............................
m ....................%%%%....
m %%..................%%%.....
m .....................%......
m .....................%......
m ............................
m ..................%.........
m ..................%.........
m ..................%%..%%....
m .......................%....
m .......................%....
