rows 28
cols 30
players 2
agents_per_player 1
a 6 15 n 0
a 20 0 n 1
m .%%.......%...................
m ...%..........................
m ..%%%....%....................
m ........%%....................
m ......%%%...............%%....
m ......%.......................
m ......%%%.%%..................
m .......%%..%..................
m ..............................
m %............................%
m ..............................
m ..............................
m ..........%%..................
m ........%%%%%............%%%..
m ................%%.......%....
m ..................%...........
m .................%%%....%.....
m .......................%%.....
m .........%%..........%%%......
m .....................%........
m .....................%%%.%%...
m ......................%%..%...
m ..............................
m ..............%%..............
m ..............................
m ..............................
m .........................%%...
m ..........%%%..........%%%%%..
