rows 28
cols 30
players 2
agents_per_player 1
a 2 19 n 0
a 16 4 n 1
m .....%....%%%.................
m ..........%...................
m ..........%...................
m ..............................
m ...............%%.............
m .........%%...................
m .........%%...............%%..
m ...................%.......%..
m .%%..............%%%..........
m %%%..............%%..........%
m %%%...............%...........
m ..%%..........................
m ...%..........................
m ....................%......%%.
m ....................%....%%%..
m .........................%....
m .........................%....
m ..............................
m %%............................
m ........................%%....
m ...........%%...........%%....
m ....%.......%.................
m ..%%%...........%%............
m ..%%..........%%%%............
m ...%...........%%%............
m .................%%...........
m ..................%...........
m .....%......%%................
