rows 30
cols 30
players 2
agents_per_player 1
a 15 25 n 0
a 0 10 n 1
m ..............................
m ..............................
m ..............................
m ...........%..................
m ...........%%%..%.............
m ...........%%%%.%%............
m ..%........%%%...%............
m ..%%..........................
m ..............................
m ..............................
m ..............................
m ............%%................
m .........%%%%..........%%.....
m .......................%%.....
m ........................%.....
m ..............................
m ..............................
m ..............................
m ..........................%...
m .%........................%%%.
m .%%.......................%%%%
m ..%..............%........%%%.
m .................%%...........
m ..............................
m ..............................
m ..............................
m ...........................%%.
m ........%%..............%%%%..
m ........%%....................
m .........%....................
