rows 30
cols 28
players 2
agents_per_player 1
a 24 17 n 0
a 9 3 n 1
m ......%%%%..................
m ............................
m ......%.....................
m .....%%..........%%%%%%.....
m .................%%%%%...%%.
m .........%.......%%%%....%..
m .........%..................
m ............................
m ............................
m ............................
m ............................
m ............................
m ............................
m ............................
m ..................%%%%......
m ....................%%%%....
m ............................
m ....................%.......
m ...%%%%%%..........%%.......
m ...%%%%%...%%...............
m ...%%%%....%...........%....
m .......................%....
m ............................
m ............................
m ............................
m ............................
m ............................
m ............................
m ............................
m ....%%%%....................
