rows 30
cols 28
players 2
agents_per_player 1
a 26 19 n 0
a 11 5 n 1
m .....................%%%....
m ...............%%....%%%....
m ...............%......%.....
m .........%%...........%.....
m ............................
m ...........%%...............
m ............................
m ............................
m ............................
m ............................
m ...........%%...............
m .........%%%................
m .........%%%................
m ...........%%%%%............
m .........%..%%.%............
m .......%%%..................
m .%%....%%%..................
m .%......%...................
m ........%..............%%...
m ............................
m .........................%%.
m ............................
m ............................
m ............................
m ............................
m .........................%%.
m .......................%%%..
m .......................%%%..
m %%.......................%%%
m .%.....................%..%%
