rows 24
cols 30
players 3
agents_per_player 1
a 17 22 n 0
a 1 12 n 1
a 9 2 n 2
m ..................%%..........
m ..............................
m ..............................
m ....%%........................
m %...........................%%
m %%...........................%
m %%...........................%
m .%.......%............%%.....%
m ........%%....................
m ..............................
m ..............................
m ........................%%....
m ..................%%%.........
m ...................%%%........
m ...................%%%........
m ............%%.....%.%.......%
m ............................%%
m ..............................
m ..............................
m ..............%%..............
m ........%%%...................
m .........%%%..................
m .........%%%..................
m ..%%.....%.%.......%..........
