rows 24
cols 22
players 2
agents_per_player 1
a 0 11 n 0
a 12 0 n 1
m ......................
m ......................
m ......................
m ......................
m ......................
m ......................
m ......................
m ..............%.......
m ..............%%......
m ......................
m ......................
m ......................
m ......................
m ......................
m ......................
m ......................
m ......................
m ......................
m ......................
m ...%..................
m ...%%.................
m ......................
m ......................
m ......................
