rows 21
cols 30
players 3
agents_per_player 1
a 9 6 n 0
a 16 26 n 1
a 2 16 n 2
m %................%....%.....%%
m %.....................%.....%%
m .............................%
m ..............................
m ..............................
m ......%%.%%...................
m .......%.%.........%..........
m .......%....%.....%%%.........
m ............%.....%%%.........
m ...................%..........
m ..............................
m ..............................
m %.........................%%.%
m .........%.................%.%
m ..%.....%%%................%..
m ..%.....%%%...................
m .........%....................
m ..............................
m ..............................
m ................%%.%%.........
m .................%.%.........%
