rows 28
cols 30
players 2
agents_per_player 1
a 16 0 n 0
a 2 15 n 1
m .........................%%...
m ..............................
m ...................%%.........
m ..................%%%.....%...
m ...................%%....%%...
m ...................%%.........
m ..............................
m ...................%%.........
m ..............................
m ..............................
m ..............................
m ..............................
m ..............................
m ........%%%...................
m ..........%%..................
m ..............................
m ....%%........................
m ...%%%.....%..................
m ....%%....%%..................
m ....%%........................
m ..............................
m ....%%........................
m ..............................
m ..............................
m ..............................
m ..............................
m ..............................
m .......................%%%....
