rows 28
cols 30
players 2
agents_per_player 1
a 2 22 n 0
a 16 7 n 1
m ..............................
m ..............................
m ..%..........%%...............
m %%%...........................
m ....%.........................
m ....%.........................
m ....%.........................
m ......%%......................
m ..............................
m ..............................
m ..............................
m ..............................
m ..............................
m ..............................
m ..............................
m ..............................
m .................%..........%%
m ...............%%%............
m ...................%..........
m ...................%..........
m ...................%..........
m .....................%%.......
m ..............................
m ..............................
m ..............................
m ..............................
m ..............................
m ..............................
