rows 30
cols 28
players 2
agents_per_player 1
a 1 18 n 0
a 16 4 n 1
m %%%%........................
m .%%%........................
m ...%%..%%...................
m %%.%%%......................
m ............................
m ............................
m ............................
m ............................
m ............................
m ............................
m ............................
m ............................
m ............................
m ...............%............
m ...............%%%..........
m ..............%%%%..........
m ...............%%%..........
m .................%%..%%.....
m ..............%%.%%%........
m ............................
m ............................
m ............................
m ............................
m ............................
m ............................
m ............................
m ............................
m ............................
m .%..........................
m .%%%........................
