rows 30
cols 28
players 2
agents_per_player 1
a 29 13 n 0
a 14 27 n 1
m ....................%%%.....
m ............%%......%%%.....
m ....................%.%.....
m ......................%.....
m ............................
m ............................
m ............................
m ............................
m ..........................%.
m .....................%%%..%.
m ............................
m ............................
m ............................
m ............................
m ......%.....................
m ......%%%...................
m ......%%%.................%%
m ......%.%...................
m ........%...................
m ............................
m ............................
m ............................
m ............................
m ............%...............
m .......%%%..%...............
m ............................
m ............................
m ............................
m ............................
m ....................%.......
