rows 30
cols 35
players 5
agents_per_player 1
a 22 21 n 0
a 10 14 n 1
a 28 7 n 2
a 16 0 n 3
a 4 28 n 4
m ..........%%.........%%.....%......
m %..........................%%......
m %..................................
m ....%..%%%.........................
m ....%%.............................
m ....%..............................
m .......%%.....%................%%..
m .............%%......%.............
m .....................%.............
m .........................%..%%%....
m .........................%%........
m .........................%.........
m %................%%.........%%.....
m %......%..........................%
m .......%...........................
m ...........%..%%%..................
m ...........%%......................
m ...........%.......................
m ...%%.........%%.....%.............
m ....................%%......%......
m ............................%......
m %%%.............................%..
m ................................%%.
m ................................%..
m %%.....%................%%.........
m ......%%......%....................
m ..............%....................
m ..................%..%%%...........
m ..................%%...............
m ..................%................
