rows 30
cols 26
players 2
agents_per_player 1
a 0 4 n 0
a 15 17 n 1
m ..........................
m ......%%%.......%%........
m ................%%........
m .................%%%......
m .................%........
m .................%........
m ......%...................
m .%%...%...................
m .%........................
m ......................%%..
m ......................%%..
m ......................%...
m ......................%...
m ..........%%..............
m ..........................
m ..........................
m ...%%..............%%%....
m ...%%.....................
m ....%%%...................
m ....%.....................
m ....%.....................
m ...................%......
m ..............%%...%......
m ..............%...........
m .........%%...............
m .........%%...............
m .........%................
m .........%................
m .......................%%.
m ..........................
