rows 30
cols 36
players 6
agents_per_player 1
a 9 11 n 0
a 4 17 n 1
a 29 23 n 2
a 24 29 n 3
a 19 35 n 4
a 14 5 n 5
m ....................................
m .........%..........................
m .........%.............%............
m .......................%............
m ....................................
m ....................................
m ...%................................
m ...%.............%..................
m .................%..................
m ....................................
m ....................................
m .................................%..
m ...........%.....................%..
m ...........%........................
m ....................................
m ....................................
m ...........................%........
m .....%.....................%........
m .....%..............................
m ....................................
m ....................................
m .....................%..............
m .....................%.............%
m ...................................%
m ....................................
m ....................................
m ...............%....................
m ...............%.............%......
m .............................%......
m ....................................
