rows 30
cols 30
players 3
agents_per_player 1
a 22 17 n 0
a 12 7 n 1
a 2 27 n 2
m ............%%.....%..........
m .......%......................
m .......%................%.....
m ...%...................%%.....
m ..%%..........................
m .%%%..........................
m .................%............
m .................%%...........
m .....................%%.......
m .....................%%%.....%
m ......................%%.....%
m .................%............
m ....%............%............
m ...%%........%................
m ............%%................
m ...........%%%................
m ...........................%..
m ...........................%%.
m .%%...........................
m .%%%.....%....................
m ..%%.....%....................
m ...........................%..
m ..............%............%..
m .............%%........%......
m ......................%%......
m .....................%%%......
m .......%......................
m .......%%.....................
m ...........%%.................
m ...........%%%.....%..........
