rows 36
cols 36
players 6
agents_per_player 1
a 15 15 n 0
a 9 9 n 1
a 3 3 n 2
a 33 33 n 3
a 27 27 n 4
a 21 21 n 5
m ....%%..............................
m ....................................
m ....................................
m ....................................
m ....................................
m ....................................
m ..........%%........................
m ....................................
m ....................................
m ....................................
m ....................................
m ....................................
m ................%%..................
m ....................................
m ....................................
m ....................................
m ....................................
m ....................................
m ......................%%............
m ....................................
m ....................................
m ....................................
m ....................................
m ....................................
m ............................%%......
m ....................................
m ....................................
m ....................................
m ....................................
m ....................................
m ..................................%%
m ....................................
m ....................................
m ....................................
m ....................................
m ....................................
