rows 20
cols 26
players 2
agents_per_player 1
a 3 1 n 0
a 13 14 n 1
m ......%%..................
m ..........................
m .................%%%......
m ..........................
m ...............%..........
m ...............%..%.%%%...
m ..................%.......
m ..........................
m .................%........
m ..............%%%%%.......
m ...................%%.....
m ..........................
m ....%%%...................
m ..........................
m ..%.......................
m ..%..%.%%%................
m .....%....................
m ..........................
m ....%.....................
m .%%%%%....................
