rows 22
cols 30
players 2
agents_per_player 1
a 4 0 n 0
a 15 15 n 1
m .............%...%%...........
m ........%........%............
m .......%%%...........%%%......
m ..............................
m ....................%.........
m ....................%......%%.
m ....................%......%%.
m .......%.....%%.............%.
m ...%%..%......................
m .......%......................
m ............................%.
m ..%%........................%.
m ..%....................%......
m ......%%%.............%%%.....
m ..............................
m .....%........................
m .....%......%%................
m .....%......%%................
m .............%........%.....%%
m ..................%%..%.......
m ......................%.......
m .............%................
