rows 35
cols 30
players 5
agents_per_player 1
a 2 0 n 0
a 16 12 n 1
a 30 24 n 2
a 9 6 n 3
a 23 18 n 4
m ....%%........................
m .....%........................
m ..............................
m ..............................
m ....%..%%.....................
m ....%%........................
m .....%.....%..................
m ..........%%..................
m ...........%..................
m ..............................
m ..............................
m ..........%..%%...............
m ..........%%..................
m ...........%.....%............
m ................%%............
m .................%............
m ..............................
m ..............................
m ................%..%%.........
m ................%%............
m .................%.....%......
m ......................%%......
m .......................%......
m ..............................
m ..............................
m ......................%..%%...
m ......................%%......
m .......................%.....%
m ............................%%
m .............................%
m ..............................
m ..............................
m .%%.........................%.
m ............................%%
m .....%.......................%
