rows 24
cols 28
players 2
agents_per_player 1
a 23 16 n 0
a 11 2 n 1
m ............%...............
m ............................
m ............................
m ............................
m ............................
m ............................
m ............%...............
m ...........%%...............
m ............................
m %...........................
m %..........................%
m ..........................%.
m ..........................%.
m ............................
m ............................
m ............................
m ............................
m ............................
m ..........................%.
m .........................%%.
m ............................
m ..............%.............
m .............%%.............
m ............%...............
