rows 50
cols 40
players 10
agents_per_player 1
a 30 39 n 0
a 25 3 n 1
a 20 7 n 2
a 15 11 n 3
a 10 15 n 4
a 5 19 n 5
a 0 23 n 6
a 45 27 n 7
a 40 31 n 8
a 35 35 n 9
m ................%%......................
m ..............%...%%..........%%........
m ..............%..%............%.........
m .......%%....%%..%............%.........
m .......%................................
m ............%%..........................
m ..........%...%%..........%%............
m ..........%..%............%.............
m ...%%....%%..%............%.............
m ...%....................................
m ........%%..............................
m ......%...%%..........%%................
m ......%..%............%.................
m %....%%..%............%................%
m .......................................%
m ....%%..................................
m ..%...%%..........%%....................
m ..%..%............%.....................
m .%%..%............%................%%...
m ...................................%....
m %%......................................
m ..%%..........%%......................%.
m .%............%.......................%.
m .%............%................%%....%%.
m ...............................%........
m ....................................%%..
m ..........%%......................%...%%
m ..........%.......................%..%..
m ..........%................%%....%%..%..
m ...........................%............
m ................................%%......
m ......%%......................%...%%....
m ......%.......................%..%......
m ......%................%%....%%..%......
m .......................%................
m ............................%%..........
m ..%%......................%...%%........
m ..%.......................%..%..........
m ..%................%%....%%..%..........
m ...................%....................
m ........................%%..............
m ......................%...%%..........%%
m ......................%..%............%.
m ...............%%....%%..%............%.
m ...............%........................
m ....................%%..................
m ..................%...%%..........%%....
m ..................%..%............%.....
m ...........%%....%%..%............%.....
m ...........%............................
