rows 24
cols 24
players 3
agents_per_player 1
a 7 20 n 0
a 23 4 n 1
a 15 12 n 2
m .........%%..%..........
m ..........%.............
m ........................
m ....................%...
m ....................%...
m ....%%.............%%...
m .....%..................
m .%%..%..................
m .%%..%..................
m ..%.....................
m ........................
m ............%...........
m ............%...........
m ...........%%.......%%..
m .....................%..
m .................%%..%..
m .................%%..%..
m ..................%.....
m ........................
m ....%...................
m ....%...................
m ...%%.......%%..........
m .............%..........
m .........%%..%..........
