rows 26
cols 22
players 2
agents_per_player 1
a 11 4 n 0
a 24 15 n 1
m ......................
m ....%%.....%%%........
m ......................
m ......................
m ......................
m ......................
m ......................
m ....................%.
m ...................%%.
m .................%%%%.
m ..................%%%.
m %...................%.
m %...................%.
m ......................
m %%%............%%.....
m ......................
m ......................
m ......................
m ......................
m ......................
m .........%............
m ........%%............
m ......%%%%............
m .......%%%............
m .........%.%..........
m .........%.%..........
