rows 21
cols 24
players 3
agents_per_player 1
a 17 7 n 0
a 10 23 n 1
a 3 15 n 2
m .......................%
m ........................
m ......%.................
m ......%.................
m ......%.................
m ......%%................
m ......%%%...............
m .......%................
m ........................
m ..............%.........
m ..............%.........
m ..............%.........
m ..............%%........
m ..............%%%.......
m ...............%........
m ........................
m ......................%.
m ......................%.
m ......................%.
m ......................%%
m %.....................%%
