rows 18
cols 22
players 2
agents_per_player 1
a 0 21 n 0
a 9 10 n 1
m ........%%............
m .............%........
m .............%........
m ......................
m ......................
m ...%..................
m ...%%%................
m ......%...............
m .%%...%...............
m ...................%%.
m ..%...................
m ..%...................
m ......................
m ......................
m ..............%.......
m ..............%%%.....
m .................%....
m ............%%...%....
