rows 24
cols 26
players 2
agents_per_player 1
a 8 5 n 0
a 20 18 n 1
m ..........................
m ..........................
m ...............%%.........
m ..........%...............
m .........%%...............
m ......%%.%%%.%%...........
m ....%%%..%%...............
m ..........................
m ..........................
m ..........................
m ..........................
m .....................%%...
m ..........................
m ..........................
m ..%%......................
m .......................%..
m ......................%%..
m %%.................%%.%%%.
m .................%%%..%%..
m ..........................
m ..........................
m ..........................
m ..........................
m ........%%................
