rows 28
cols 28
players 4
agents_per_player 1
a 27 20 n 0
a 20 13 n 1
a 13 6 n 2
a 6 27 n 3
m ...............%............
m ...............%............
m ............................
m ...........................%
m ...........................%
m ............................
m ............................
m ......................%.....
m ......................%.....
m ............................
m ......%.....................
m ......%.....................
m ............................
m ............................
m .%..........................
m .%..........................
m ............................
m .............%..............
m .............%..............
m ............................
m ............................
m ........%...................
m ........%...................
m ............................
m ....................%.......
m ....................%.......
m ............................
m ............................
