rows 30
cols 27
players 3
agents_per_player 1
a 21 1 n 0
a 1 10 n 1
a 11 19 n 2
m ...........................
m %%.........................
m .%.........................
m ...........................
m ...........................
m ...........................
m ......%.....%..............
m ......%...%%%..............
m ...........................
m ...........................
m ...........................
m .........%%................
m ..........%................
m ...........................
m ...........................
m ...........................
m ...............%.....%.....
m ...............%...%%%.....
m ...........................
m ...........................
m ...........................
m ..................%%.......
m ...................%.......
m ...........................
m ...........................
m ...........................
m ...%....................%..
m .%%%....................%..
m ...........................
m ...........................
