rows 30
cols 42
players 6
agents_per_player 1
a 10 18 n 0
a 5 25 n 1
a 0 32 n 2
a 25 39 n 3
a 20 4 n 4
a 15 11 n 5
m ...................%........%%............
m ................%%%.......................
m .................%%.......................
m .................%%.......................
m ...........%%.............................
m ............%........%%...................
m .........%%%..............................
m ..........%%..............................
m ..........%%..............................
m ....%%....................................
m .....%........%%..........................
m ..%%%.....................................
m ...%%.....................................
m ...%%.....................................
m .......................................%%.
m .......%%...............................%.
m .....................................%%%..
m ......................................%%..
m ......................................%%..
m ................................%%........
m %%...............................%........
m ..............................%%%.........
m ...............................%%.........
m ...............................%%.........
m .........................%%...............
m ..........................%........%%.....
m .......................%%%................
m ........................%%................
m ........................%%................
m ..................%%......................
