rows 28
cols 28
players 4
agents_per_player 1
a 19 27 n 0
a 26 20 n 1
a 5 13 n 2
a 12 6 n 3
m ............................
m ............................
m ...........%................
m ..........%%................
m ............................
m .%..........................
m .%..........................
m ............................
m ............................
m ....%.......................
m ...%%.......................
m ............................
m ......................%.....
m ......................%.....
m ............................
m ............................
m .........................%..
m ........................%%..
m ............................
m ...............%............
m ...............%............
m ............................
m ............................
m ..................%.........
m .................%%.........
m ............................
m ........%...................
m ........%...................
