rows 30
cols 42
players 6
agents_per_player 1
a 8 28 n 0
a 3 35 n 1
a 28 0 n 2
a 23 7 n 3
a 18 14 n 4
a 13 21 n 5
m ................%.%.......................
m ................%%%..%%...................
m ..............%%..........................
m ..........................................
m .........%................................
m .........%.%..............................
m .........%%%..%%..........................
m .......%%.................................
m ..........................................
m ..%.......................................
m ..%.%.....................................
m ..%%%..%%.................................
m %%........................................
m ..........................................
m .....................................%....
m .....................................%.%..
m %%...................................%%%..
m ...................................%%.....
m ..........................................
m ..............................%...........
m ..............................%.%.........
m ..............................%%%..%%.....
m ............................%%............
m ..........................................
m .......................%..................
m .......................%.%................
m .......................%%%..%%............
m .....................%%...................
m ..........................................
m ................%.........................
