rows 36
cols 30
players 6
agents_per_player 1
a 20 27 n 0
a 26 22 n 1
a 32 17 n 2
a 2 12 n 3
a 8 7 n 4
a 14 2 n 5
m ..............................
m ..............................
m ..............................
m .%............................
m .%............................
m ..............................
m ..............................
m ..............................
m ..............................
m ..........................%...
m ..........................%...
m ..............................
m ..............................
m ..............................
m ..............................
m .....................%........
m .....................%........
m ..............................
m ..............................
m ..............................
m ..............................
m ................%.............
m ................%.............
m ..............................
m ..............................
m ..............................
m ..............................
m ...........%..................
m ...........%..................
m ..............................
m ..............................
m ..............................
m ..............................
m ......%.......................
m ......%.......................
m ..............................
