rows 32
cols 56
players 8
agents_per_player 1
a 12 28 n 0
a 0 49 n 1
a 20 14 n 2
a 8 35 n 3
a 28 0 n 4
a 16 21 n 5
a 4 42 n 6
a 24 7 n 7
m ...............................%........................
m ..........................%%............................
m ........................%...............................
m ........................%...............................
m ........................%...............................
m ...................%%...................................
m .................%......................................
m .................%......................................
m .................%......................................
m ............%%..........................................
m ..........%.............................................
m ..........%.............................................
m ..........%.............................................
m .....%%.................................................
m ...%....................................................
m ...%....................................................
m ...%....................................................
m ......................................................%%
m ....................................................%...
m ....................................................%...
m ....................................................%...
m ...............................................%%.......
m .............................................%..........
m .............................................%..........
m .............................................%..........
m ........................................%%..............
m ......................................%.................
m ......................................%.................
m ......................................%.................
m .................................%%.....................
m ...............................%........................
m ...............................%........................
