rows 21
cols 27
players 3
agents_per_player 1
a 2 17 n 0
a 16 26 n 1
a 9 8 n 2
m ...........................
m .......................%...
m ...%%........%........%%%..
m ....%........%.........%...
m .............%........%%...
m ......................%....
m ...........................
m ...........................
m ..............%............
m ....%........%%%.....%%....
m ....%.........%.......%....
m ....%........%%............
m .............%.............
m ...........................
m ...........................
m .....%.....................
m ....%%%.....%%........%....
m .....%.......%........%....
m ....%%................%....
m ....%......................
m ...........................
