rows 28
cols 28
players 4
agents_per_player 1
a 14 14 n 0
a 7 7 n 1
a 0 0 n 2
a 21 21 n 3
m ...............%............
m ............................
m ............%%...........%..
m .........................%..
m ............................
m ............................
m ......................%%....
m ......................%.....
m ............................
m ....%..............%%.......
m ....%.......................
m ............................
m ............................
m .%%.........................
m .%..........................
m ............................
m ...........%..............%%
m ...........%................
m ............................
m ............................
m ........%%..................
m ........%...................
m ............................
m .....%%...........%.........
m ..................%.........
m ............................
m ............................
m ...............%%...........
