rows 42
cols 36
players 6
agents_per_player 1
a 14 7 n 0
a 7 13 n 1
a 0 19 n 2
a 35 25 n 3
a 28 31 n 4
a 21 1 n 5
m ..................................%%
m %...........%.....................%%
m ............%.....................%%
m ....................................
m %..................................%
m ...................................%
m ..................................%%
m ............................%%......
m ......%.....................%%%.....
m ......%.....................%%......
m ....................................
m .............................%%.....
m .............................%......
m ............................%%......
m ......................%%............
m %.....................%%%...........
m %.....................%%............
m ....................................
m .......................%%...........
m .......................%............
m ......................%%............
m ................%%..................
m ................%%%...........%.....
m ................%%............%.....
m ....................................
m .................%%.................
m .................%..................
m ................%%..................
m ..........%%........................
m ..........%%%...........%...........
m ..........%%............%...........
m ....................................
m ...........%%.......................
m ...........%........................
m ..........%%........................
m ....%%..............................
m ....%%%...........%.................
m ....%%............%.................
m ....................................
m .....%%.............................
m .....%..............................
m ....%%..............................
