rows 26
cols 24
players 2
agents_per_player 1
a 17 21 n 0
a 4 9 n 1
m ........................
m .......................%
m %......................%
m ........................
m ........................
m ................%.......
m ................%.%%....
m .................%%%%...
m ..................%.....
m ................%%......
m ........................
m ........................
m ........................
m ........................
m ...........%............
m ...........%%...........
m ........................
m ........................
m ....%...................
m ....%.%%................
m .....%%%%...............
m ......%.................
m ....%%..................
m ........................
m ........................
m ........................
