rows 28
cols 26
players 2
agents_per_player 1
a 13 10 n 0
a 27 23 n 1
m ..........................
m %........................%
m %.......................%%
m %......................%%%
m ......................%%%.
m .....................%%%%.
m ..........................
m ......................%%%.
m ......................%...
m ..........................
m ..........................
m ..........................
m %.........................
m %%.......................%
m ..........................
m ............%%............
m ...........%%%............
m ..........%%%%............
m .........%%%..............
m ........%%%%..............
m ..........................
m .........%%%..............
m .........%................
m ..........................
m ..........................
m ..........................
m .............%............
m ............%%%...........
