rows 21
cols 30
players 3
agents_per_player 1
a 1 14 n 0
a 8 24 n 1
a 15 4 n 2
m ..............................
m %.............................
m %.............................
m ............................%%
m .....%%......................%
m %....%%.................%....%
m .......................%%.....
m ..............................
m ..........%...................
m ..........%...................
m ........%%....................
m .........%.....%%.............
m ....%....%%....%%.............
m ...%%.........................
m ..............................
m ....................%.........
m ....................%.........
m ..................%%..........
m ...................%.....%%...
m ..............%....%%....%%...
m .............%%...............
