rows 18
cols 18
players 2
agents_per_player 1
a 3 12 n 0
a 12 3 n 1
m .................%
m .................%
m ..................
m .%%...............
m ..................
m .........%%%......
m ..........%.......
m ........%.........
m ........%.........
m ........%.........
m ........%.........
m ..................
m ..........%%......
m ..................
m %%%...............
m .%................
m .................%
m .................%
