rows 18
cols 30
players 2
agents_per_player 1
a 1 1 n 0
a 10 16 n 1
m ..............................
m ..............................
m ..............................
m ..............................
m ..............................
m ..............................
m ...%%.......%%................
m ...%.........%%............%%.
m ...%........................%.
m ..............................
m ..............................
m ..............................
m ..............................
m ..............................
m ..............................
m ..................%%.......%%.
m ............%%....%.........%%
m .............%....%...........
