rows 35
cols 30
players 5
agents_per_player 1
a 18 20 n 0
a 32 14 n 1
a 11 8 n 2
a 25 2 n 3
a 4 26 n 4
m ..............................
m ..............................
m .............................%
m %............................%
m %............................%
m .............................%
m ..............................
m ..............................
m ..............................
m ...........%..................
m ...........%%.................
m ...........%%.................
m ...........%..................
m ..............................
m ..............................
m ..............................
m .......................%......
m .......................%%.....
m .......................%%.....
m .......................%......
m ..............................
m ..............................
m ..............................
m .....%........................
m .....%%.......................
m .....%%.......................
m .....%........................
m ..............................
m ..............................
m ..............................
m .................%............
m .................%%...........
m .................%%...........
m .................%............
m ..............................
