rows 28
cols 26
players 2
agents_per_player 1
a 1 13 n 0
a 15 0 n 1
m ..%.................%.....
m %%%%...............%%.....
m %%%.....%................%
m .%......%.................
m .%.....%%.................
m .......%%%................
m ..........................
m ..........................
m .......%%.................
m .......%..................
m ..........................
m ........%%......%.........
m ..............%%%.........
m ..............%%%.........
m .......%.......%..........
m ......%%.....%%%%.........
m ............%%%%.....%....
m ..............%......%....
m ..............%.....%%....
m ....................%%%...
m ..........................
m ..........................
m ....................%%....
m ....................%.....
m ..........................
m ...%.................%%...
m .%%%......................
m .%%%......................
