rows 28
cols 24
players 2
agents_per_player 1
a 26 9 n 0
a 12 21 n 1
m ........................
m ........................
m ........................
m ........................
m ........................
m ......%.................
m ......%.................
m ......%..........%%.....
m ......%..........%......
m .................%.%%...
m .................%.%%%..
m ........................
m .................%%.....
m ........%%.......%......
m ........................
m ........................
m ........................
m ........................
m ........................
m ..................%.....
m ..................%.....
m .....%%...........%.....
m .....%............%.....
m .....%.%%...............
m .....%.%%%..............
m ........................
m .....%%.................
m .....%..............%%..
