rows 35
cols 30
players 5
agents_per_player 1
a 1 27 n 0
a 29 9 n 1
a 22 21 n 2
a 15 3 n 3
a 8 15 n 4
m ......................%%%.....
m ....................%.%.......
m ....................%.........
m ..............................
m ..............................
m ............%%..%%............
m ..........%%%.................
m ..........%%%.................
m ........%.%...................
m ........%.....................
m ..............................
m ..............................
m %%..%%........................
m %...........................%%
m %...........................%%
m ..........................%.%.
m ..........................%...
m ..............................
m ..............................
m ..................%%..%%......
m ................%%%...........
m ................%%%...........
m ..............%.%.............
m ..............%...............
m ..............................
m ..............................
m ......%%..%%..................
m ....%%%.......................
m ....%%%.......................
m ..%.%.........................
m ..%...........................
m ..............................
m ..............................
m ........................%%..%%
m ......................%%%.....
