rows 30
cols 42
players 6
agents_per_player 1
a 9 6 n 0
a 4 13 n 1
a 29 20 n 2
a 24 27 n 3
a 19 34 n 4
a 14 41 n 5
m ....%%%........%%.........................
m .....%%%%.......%%..............%.........
m .......%........%..............%%.........
m ...............................%..........
m .%%.......................................
m ........%%.............................%%%
m %%.......%%..............%..............%%
m %........%..............%%................
m ........................%.................
m ....................................%%....
m .%%.............................%%%.......
m ..%%..............%..............%%%%.....
m ..%..............%%................%......
m .................%........................
m .............................%%...........
m .........................%%%........%%....
m ...........%..............%%%%.......%%...
m ..........%%................%........%....
m ..........%...............................
m ......................%%..................
m ..................%%%........%%...........
m ....%..............%%%%.......%%..........
m ...%%................%........%...........
m ...%......................................
m ...............%%.........................
m ...........%%%........%%..................
m ............%%%%.......%%..............%..
m ..............%........%..............%%..
m ......................................%...
m ........%%................................
