rows 22
cols 28
players 2
agents_per_player 1
a 9 19 n 0
a 20 5 n 1
m ............................
m ............................
m ....................%%......
m %..........................%
m ............................
m ............................
m ............................
m ............................
m ............................
m ...........%%...............
m ............................
m ............................
m ............................
m ......%%....................
m .............%%.............
m ............................
m ............................
m ............................
m ............................
m ............................
m .........................%%.
m ............................
