rows 27
cols 21
players 3
agents_per_player 1
a 9 18 n 0
a 0 11 n 1
a 18 4 n 2
m ..............%%%....
m .....................
m .....................
m .....................
m .....................
m .....................
m .......%%............
m ........%............
m .%...................
m %%%..................
m .....................
m .....................
m .....................
m .....................
m .....................
m ..............%%.....
m ...............%.....
m ........%............
m .......%%%...........
m .....................
m .....................
m .....................
m .....................
m .....................
m %%...................
m .%...................
m ...............%.....
