rows 24
cols 24
players 3
agents_per_player 1
a 15 4 n 0
a 7 12 n 1
a 23 20 n 2
m ........................
m ........................
m ........................
m .....%%.................
m .....%%.................
m .....%%.................
m ......%%%...............
m .......%................
m ........................
m ........................
m ........................
m .....................%%.
m .....................%%.
m .....................%%.
m %.....................%%
m .......................%
m ........................
m ........................
m ........................
m .............%%.........
m .............%%.........
m .............%%.........
m ..............%%%.......
m ...............%........
