rows 60
cols 70
players 10
agents_per_player 1
a 3 16 n 0
a 9 23 n 1
a 15 30 n 2
a 21 37 n 3
a 27 44 n 4
a 33 51 n 5
a 39 58 n 6
a 45 65 n 7
a 51 2 n 8
a 57 9 n 9
m ......................%...............................................
m ....%...........................................%%...........%%.......
m ....%...........................................%.....................
m ................................................%.....................
m ................................................%.....................
m .............................%........................................
m .............................%........................................
m ...........%...........................................%%...........%%
m ...........%...........................................%..............
m .......................................................%..............
m .......................................................%..............
m ....................................%.................................
m ....................................%.................................
m .....%%...........%...........................................%%......
m ..................%...........................................%.......
m ..............................................................%.......
m ..............................................................%.......
m ...........................................%..........................
m ...........................................%..........................
m %...........%%...........%...........................................%
m .........................%...........................................%
m .....................................................................%
m .....................................................................%
m ..................................................%...................
m ..................................................%...................
m ......%%...........%%...........%.....................................
m ......%.........................%.....................................
m ......%...............................................................
m ......%...............................................................
m .........................................................%............
m .........................................................%............
m .............%%...........%%...........%..............................
m .............%.........................%..............................
m .............%........................................................
m .............%........................................................
m ................................................................%.....
m ................................................................%.....
m ....................%%...........%%...........%.......................
m ....................%.........................%.......................
m ....................%.................................................
m ....................%.................................................
m .%....................................................................
m .%....................................................................
m ...........................%%...........%%...........%................
m ...........................%.........................%................
m ...........................%..........................................
m ...........................%..........................................
m ........%.............................................................
m ........%.............................................................
m ..................................%%...........%%...........%.........
m ..................................%.........................%.........
m ..................................%...................................
m ..................................%...................................
m ...............%......................................................
m ...............%......................................................
m .........................................%%...........%%...........%..
m .........................................%.........................%..
m .........................................%............................
m .........................................%............................
m ......................%...............................................
