rows 24
cols 24
players 3
agents_per_player 1
a 13 2 n 0
a 21 10 n 1
a 5 18 n 2
m ........................
m ........................
m %%.....................%
m %....%%................%
m .%.%...................%
m .%.%....................
m ........................
m ........................
m ........................
m ........................
m .......%%%..............
m .......%%....%%.........
m .......%.%.%............
m .........%.%............
m ........................
m ........................
m ........................
m ........................
m ...............%%%......
m ...............%%....%%.
m ...............%.%.%....
m .................%.%....
m ........................
m ........................
