rows 35
cols 30
players 5
agents_per_player 1
a 0 7 n 0
a 21 19 n 1
a 7 1 n 2
a 28 13 n 3
a 14 25 n 4
m ..............................
m ..............................
m ...................%%.........
m ...................%..........
m ..........%%%......%..........
m ..........%........%..........
m ..............................
m ..............................
m ..............................
m .............%%...............
m .............%................
m ....%%%......%................
m ....%........%................
m ..............................
m ..............................
m ..............................
m .......%%.....................
m .......%......................
m %......%....................%%
m .......%....................%.
m ..............................
m ..............................
m ..............................
m .%%...........................
m .%............................
m .%....................%%%.....
m .%....................%.......
m ..............................
m ..............................
m ..............................
m .........................%%...
m .........................%....
m ................%%%......%....
m ................%........%....
m ..............................
