rows 30
cols 60
players 10
agents_per_player 1
a 25 35 n 0
a 16 17 n 1
a 7 59 n 2
a 28 41 n 3
a 19 23 n 4
a 10 5 n 5
a 1 47 n 6
a 22 29 n 7
a 13 11 n 8
a 4 53 n 9
m %.........................%%................................
m %.............%..........%%.................................
m ..............%.............................................
m ......%.........................%%..........................
m ......%.............%..........%%...........................
m ....................%.......................................
m ............%.........................%%....................
m ............%.............%..........%%.....................
m ..........................%.................................
m ..................%.........................%%..............
m ..................%.............%..........%%...............
m ................................%...........................
m ........................%.........................%%........
m ........................%.............%..........%%.........
m ......................................%.....................
m ..............................%.........................%%..
m ..............................%.............%..........%%...
m ............................................%...............
m ..%%................................%.......................
m .%%.................................%.............%.........
m ..................................................%.........
m ........%%................................%.................
m .......%%.................................%.............%...
m ........................................................%...
m ..............%%................................%...........
m ..%..........%%.................................%...........
m ..%.........................................................
m ....................%%................................%.....
m ........%..........%%.................................%.....
m ........%...................................................
