rows 63
cols 63
players 9
agents_per_player 1
a 6 18 n 0
a 34 32 n 1
a 62 46 n 2
a 27 60 n 3
a 55 11 n 4
a 20 25 n 5
a 48 39 n 6
a 13 53 n 7
a 41 4 n 8
m ..................%%%.....%%%%............%%%...............%%.
m ..........................%%%%..............................%%.
m ............................................................%%.
m %..............................................%%...........%%%
m ...............................................%%..............
m ......................................................%.......%
m %%..............%....................................%%%......%
m %%............%%%...............%%...................%%%.....%%
m %%..............................%%...........................%%
m ................................%%.............................
m ...................%%...........%%%%...........................
m ...................%%..........................................
m ..........................%.......%............................
m .........................%%%......%%%..............%...........
m ....%%...................%%%.....%%%%............%%%...........
m ....%%...........................%%%%..........................
m ....%%.........................................................
m ....%%%%..............................................%%.......
m ......................................................%%.......
m ......%......................................................%.
m ......%%%..............%....................................%%%
m .....%%%%............%%%...............%%...................%%%
m .....%%%%..............................%%......................
m .......................................%%......................
m ..........................%%...........%%%%....................
m ..........................%%...................................
m .................................%.......%.....................
m ................................%%%......%%%..............%....
m ...........%%...................%%%.....%%%%............%%%....
m ...........%%...........................%%%%...................
m ...........%%..................................................
m ...........%%%%..............................................%%
m .............................................................%%
m .....%.......%.................................................
m ....%%%......%%%..............%................................
m ....%%%.....%%%%............%%%...............%%...............
m ............%%%%..............................%%...............
m ..............................................%%...............
m .................................%%...........%%%%.............
m .................................%%............................
m ........................................%.......%..............
m ..%....................................%%%......%%%............
m %%%...............%%...................%%%.....%%%%............
m ..................%%...........................%%%%............
m ..................%%...........................................
m .....%%...........%%%%.........................................
m .....%%........................................................
m ............%.......%..........................................
m ...........%%%......%%%..............%.........................
m ...........%%%.....%%%%............%%%...............%%........
m ...................%%%%..............................%%........
m .....................................................%%........
m ........................................%%...........%%%%......
m ........................................%%.....................
m ...............................................%.......%.......
m .........%....................................%%%......%%%.....
m .......%%%...............%%...................%%%.....%%%%.....
m .........................%%...........................%%%%.....
m .........................%%....................................
m ............%%...........%%%%..................................
m ............%%.................................................
m ...................%.......%...................................
m ..................%%%......%%%..............%..................
