rows 30
cols 42
players 6
agents_per_player 1
a 12 10 n 0
a 7 3 n 1
a 2 38 n 2
a 27 31 n 3
a 22 24 n 4
a 17 17 n 5
m ....%%%...................................
m ....%.%%..................................
m ............%%............................
m ............%%............................
m ............%%............................
m ...........%%%............................
m ...........%.%%...........................
m ...................%%.....................
m ...................%%.....................
m ...................%%.....................
m ..................%%%.....................
m ..................%.%%....................
m ..........................%%..............
m ..........................%%..............
m ..........................%%..............
m .........................%%%..............
m .........................%.%%.............
m .................................%%.......
m .................................%%.......
m .................................%%.......
m ................................%%%.......
m ................................%.%%......
m ........................................%%
m ........................................%%
m ........................................%%
m .......................................%%%
m %......................................%.%
m .....%%...................................
m .....%%...................................
m .....%%...................................
