rows 30
cols 30
players 5
agents_per_player 1
a 1 2 n 0
a 13 20 n 1
a 25 8 n 2
a 7 26 n 3
a 19 14 n 4
m ..............................
m ..............................
m ..........%%..................
m ...........%%.................
m ............%.................
m ..............................
m ..............................
m ..............................
m ....%%........................
m .....%%.......................
m ......%.......................
m ..............................
m ..............................
m ..............................
m ............................%%
m %............................%
m %.............................
m ..............................
m ..............................
m ..............................
m ......................%%......
m .......................%%.....
m ........................%.....
m ..............................
m ..............................
m ..............................
m ................%%............
m .................%%...........
m ..................%...........
m ..............................
