rows 28
cols 28
players 4
agents_per_player 1
a 10 4 n 0
a 17 25 n 1
a 24 18 n 2
a 3 11 n 3
m .........%%.................
m .........%%%................
m ....%%...%..................
m ............................
m .....%%.....................
m ....%%......................
m .....................%%%%...
m ..%%........................
m ..%%%.......................
m ..%......................%%.
m ............................
m ..........................%%
m .........................%%.
m ..............%%%%..........
m .......................%%...
m .......................%%%..
m ..................%%...%....
m ............................
m ...................%%.......
m ..................%%........
m .......%%%%.................
m ................%%..........
m ................%%%.........
m ...........%%...%...........
m ............................
m ............%%..............
m ...........%%...............
m %%%%........................
