rows 28
cols 28
players 4
agents_per_player 1
a 20 26 n 0
a 27 5 n 1
a 6 12 n 2
a 13 19 n 3
m .........................%%.
m ..........................%.
m ..........................%.
m ............%%..%%..........
m ............................
m ......%%....................
m .....%%%....................
m ....%%......................
m .....%......................
m .....%......................
m ...................%%..%%...
m ............................
m .............%%.............
m ............%%%.............
m ...........%%...............
m ............%...............
m ............%...............
m ..%%......................%%
m ............................
m ....................%%......
m ...................%%%......
m ..................%%........
m ...................%........
m ...................%........
m .....%%..%%.................
m ............................
m %..........................%
m %.........................%%
