rows 35
cols 35
players 5
agents_per_player 1
a 14 31 n 0
a 28 24 n 1
a 7 17 n 2
a 21 10 n 3
a 0 3 n 4
m ...................................
m ...................................
m ...................................
m .%.................................
m .%%................................
m .%%................................
m .%.................................
m ...................................
m ...................................
m ...................................
m ...............%...................
m ...............%%..................
m ...............%%..................
m ...............%...................
m ...................................
m ...................................
m ...................................
m .............................%.....
m .............................%%....
m .............................%%....
m .............................%.....
m ...................................
m ...................................
m ...................................
m ........%..........................
m ........%%.........................
m ........%%.........................
m ........%..........................
m ...................................
m ...................................
m ...................................
m ......................%............
m ......................%%...........
m ......................%%...........
m ......................%............
