rows 22
cols 20
players 2
agents_per_player 1
a 12 18 n 0
a 1 8 n 1
m ....................
m ....%...............
m ....%...............
m .%%.................
m .%%.................
m %%..................
m .%%.................
m .%%%.............%%.
m ..%.................
m ....................
m ....................
m ....................
m ..............%.....
m ..............%.....
m ...........%%.......
m ...........%%.......
m ..........%%........
m ...........%%.......
m .......%%..%%%......
m ............%.......
m ....................
m ....................
