rows 20
cols 26
players 2
agents_per_player 1
a 4 7 n 0
a 14 20 n 1
m ..........................
m ..........................
m ..........................
m ..........%.%%............
m ..........%%%.............
m ............%.............
m .........%%...............
m ..........................
m ..........................
m ..........................
m ..........................
m ..........................
m ..........................
m %......................%.%
m .......................%%%
m .........................%
m ......................%%..
m ..........................
m ..........................
m ..........................
