rows 30
cols 30
players 6
agents_per_player 1
a 5 28 n 0
a 0 23 n 1
a 25 18 n 2
a 20 13 n 3
a 15 8 n 4
a 10 3 n 5
m ..........%...................
m ..............................
m ...........%%.................
m ..........%%..................
m ...............%..............
m ...............%..............
m ..............................
m ................%%............
m ...............%%.............
m ....................%.........
m ....................%.........
m ..............................
m .....................%%.......
m ....................%%........
m .........................%....
m .........................%....
m ..............................
m ..........................%%..
m .........................%%...
m %.............................
m %.............................
m ..............................
m .%%...........................
m %%............................
m .....%........................
m .....%........................
m ..............................
m ......%%......................
m .....%%.......................
m ..........%...................
