rows 24
cols 20
players 2
agents_per_player 1
a 1 1 n 0
a 13 11 n 1
m ....................
m ....................
m .....%..............
m .....%..............
m ....................
m .%%.................
m ..%.................
m ....................
m ....................
m ....................
m ....................
m ....................
m ....................
m ....................
m ...............%....
m ...............%....
m ....................
m ...........%%.......
m ............%.......
m ....................
m ....................
m ....................
m ....................
m ....................
