rows 28
cols 28
players 4
agents_per_player 1
a 14 6 n 0
a 7 27 n 1
a 0 20 n 2
a 21 13 n 3
m ............................
m ........................%...
m ..................%%....%...
m ..............%%..%.........
m ..............%%...%%.......
m ..................%%........
m ............................
m ............................
m ...%........................
m ...%.....................%%.
m .....................%%..%..
m .....................%%...%%
m .........................%%.
m ............................
m ............................
m ..........%.................
m ....%%....%.................
m %%..%.......................
m %%...%%.....................
m ....%%......................
m ............................
m ............................
m .................%..........
m ...........%%....%..........
m .......%%..%................
m .......%%...%%..............
m ...........%%...............
m ............................
