rows 30
cols 42
players 6
agents_per_player 1
a 17 36 n 0
a 22 29 n 1
a 27 22 n 2
a 2 15 n 3
a 7 8 n 4
a 12 1 n 5
m ........................................%.
m ........................................%.
m .....................%%...%%%.............
m ......................%%..%...............
m ................................%%%.......
m .................................%........
m .................................%........
m ..............%%...%%%....................
m ...............%%..%......................
m .........................%%%..............
m ..........................%...............
m ..........................%...............
m .......%%...%%%...........................
m ........%%..%.............................
m ..................%%%.....................
m ...................%......................
m ...................%......................
m %%...%%%..................................
m .%%..%....................................
m ...........%%%............................
m ............%.............................
m ............%.............................
m %..................................%%...%%
m ....................................%%..%.
m ....%%%...................................
m .....%....................................
m .....%....................................
m ............................%%...%%%......
m .............................%%..%........
m .......................................%%%
