rows 21
cols 30
players 3
agents_per_player 1
a 5 22 n 0
a 19 2 n 1
a 12 12 n 2
m .........................%%%%%
m ...........................%%.
m ...........................%%.
m ............%.................
m ...........%%%................
m ..............................
m ................%%.%..........
m ...............%%%%%..........
m .................%%...........
m .................%%...........
m ..%...........................
m .%%%..........................
m ..............................
m ......%%.%....................
m .....%%%%%....................
m .......%%.....................
m .......%%.....................
m ......................%.......
m .....................%%%......
m ..............................
m ..........................%%.%
