rows 42
cols 36
players 6
agents_per_player 1
a 13 30 n 0
a 6 24 n 1
a 41 18 n 2
a 34 12 n 3
a 27 6 n 4
a 20 0 n 5
m ........%........................%..
m ...%%...%...........................
m ..%%................................
m ....................%%..............
m ....................%%..............
m .....................%..............
m ..%%................................
m ...%..........%.....................
m .........%%...%.....................
m ........%%..........................
m ..........................%%........
m ..........................%%........
m ...........................%........
m ........%%..........................
m .........%..........%...............
m ...............%%...%...............
m ..............%%....................
m ................................%%..
m ................................%%..
m .................................%..
m ..............%%....................
m ...............%..........%.........
m .....................%%...%.........
m ....................%%..............
m ..%%................................
m ..%%................................
m ...%................................
m ....................%%..............
m .....................%..........%...
m ...........................%%...%...
m ..........................%%........
m ........%%..........................
m ........%%..........................
m .........%..........................
m ..........................%%........
m ..%........................%........
m ..%..............................%%.
m ................................%%..
m ..............%%....................
m ..............%%....................
m ...............%....................
m ................................%%..
