rows 16
cols 24
players 2
agents_per_player 1
a 8 16 n 0
a 0 4 n 1
m ....................%%%%
m .........%..............
m .........%..............
m ........%%..............
m ........................
m ........................
m ........%...............
m ........%...............
m ........%%%%............
m .....................%..
m .....................%..
m ....................%%..
m ........................
m ........................
m ....................%...
m ....................%...
