rows 16
cols 18
players 2
agents_per_player 1
a 11 1 n 0
a 3 10 n 1
m ..............%.%.
m ................%.
m ..................
m .....%%...........
m ..................
m ..................
m ...............%..
m .....%.........%..
m .....%.%..........
m .......%..........
m ..................
m ..............%%..
m ..................
m ..................
m ......%...........
m ......%.......%...
