rows 26
cols 28
players 2
agents_per_player 1
a 21 19 n 0
a 8 5 n 1
m ............................
m ............................
m ............................
m ............................
m ............................
m ....................%.......
m ...................%%%......
m ............................
m .........%%%................
m ..........%%................
m ............................
m ............................
m ............................
m ............................
m ............................
m ............................
m ............................
m ............................
m ......%.....................
m .....%%%....................
m ............................
m .......................%%%..
m ........................%%..
m ............................
m ............................
m ............................
