rows 30
cols 24
players 3
agents_per_player 1
a 21 23 n 0
a 1 15 n 1
a 11 7 n 2
m ...%....%%..............
m .%%%....%...............
m ........%...............
m ........%...............
m ........................
m ..%%....................
m ........................
m ........................
m ........................
m .%......................
m %%.................%....
m %................%%%....
m %.......................
m %.......................
m ........................
m ..................%%....
m ........................
m ........................
m ........................
m .................%......
m ...........%....%%......
m .........%%%....%.......
m ................%.......
m ................%.......
m ........................
m ..........%%............
m ........................
m ........................
m ........................
m .........%..............
