rows 28
cols 28
players 4
agents_per_player 1
a 3 23 n 0
a 10 2 n 1
a 17 9 n 2
a 24 16 n 3
m ............................
m %..............%..........%%
m ...............%%%..........
m ...........%..%%.%..........
m .......%%..%................
m ............................
m ............................
m ............................
m .....%%%..............%.....
m ......................%%%...
m ..................%..%%.%...
m ..............%%..%.........
m ............................
m ............................
m ............................
m .%..........%%%.............
m .%%%........................
m %%.%.....................%..
m .....................%%..%..
m ............................
m ............................
m ............................
m ........%..........%%%......
m ........%%%.................
m ....%..%%.%.................
m %%..%.......................
m ............................
m ............................
