rows 35
cols 35
players 7
agents_per_player 1
a 27 0 n 0
a 2 30 n 1
a 12 25 n 2
a 22 20 n 3
a 32 15 n 4
a 7 10 n 5
a 17 5 n 6
m ...................................
m ......%............................
m .....%%.......%%...................
m ......%............................
m ...................................
m ...................................
m .....................%.............
m ....................%%.......%%....
m .....................%.............
m ...................................
m ...................................
m .%.................................
m %%.......%%........................
m .%.................................
m ...................................
m ...................................
m ................%..................
m ...............%%.......%%.........
m ................%..................
m ...................................
m ...................................
m ...............................%...
m ....%%........................%%...
m ...............................%...
m ...................................
m ...................................
m ...........%.......................
m ..........%%.......%%..............
m ...........%.......................
m ...................................
m ...................................
m ..........................%........
m %........................%%.......%
m ..........................%........
m ...................................
