rows 21
cols 24
players 3
agents_per_player 1
a 16 8 n 0
a 9 0 n 1
a 2 16 n 2
m ......................%%
m ......................%.
m ........................
m ........................
m ...................%%...
m ........................
m ........................
m ......%%................
m ......%.................
m ........................
m ........................
m ...%%...................
m ........................
m ........................
m ..............%%........
m ..............%.........
m ........................
m ........................
m ...........%%...........
m ........................
m ........................
