rows 35
cols 35
players 7
agents_per_player 1
a 11 24 n 0
a 21 34 n 1
a 31 9 n 2
a 6 19 n 3
a 16 29 n 4
a 26 4 n 5
a 1 14 n 6
m ...................................
m ...........%%......................
m ........%%%%.........%%%.....%.....
m .......................%%....%.....
m .......................%...........
m ...................................
m ................%%.................
m .............%%%%.........%%%.....%
m ............................%%....%
m ............................%......
m ...................................
m .....................%%............
m ....%.............%%%%.........%%%.
m ....%............................%%
m .................................%.
m ...................................
m ..........................%%.......
m .%%%.....%.............%%%%........
m ...%%....%.........................
m ...%...............................
m ...................................
m ...............................%%..
m ......%%%.....%.............%%%%...
m ........%%....%....................
m ........%..........................
m ...................................
m .%%................................
m %%.........%%%.....%.............%%
m .............%%....%...............
m .............%.....................
m ...................................
m ......%%...........................
m ...%%%%.........%%%.....%..........
m ..................%%....%..........
m ..................%................
