rows 24
cols 30
players 3
agents_per_player 1
a 5 1 n 0
a 21 11 n 1
a 13 21 n 2
m ..............................
m ..............................
m ..............................
m ..............................
m ..............%%..............
m .............%.%..............
m .............%................
m .........................%%%%.
m ..............................
m ..............................
m ..............................
m ..............................
m ....%%........................
m ...%.%........................
m ...%..........................
m ...............%%%%...........
m ..............................
m ..............................
m ..............................
m ..............................
m ........................%%....
m .......................%.%....
m .......................%......
m .....%%%%.....................
