rows 21
cols 21
players 3
agents_per_player 1
a 4 13 n 0
a 11 20 n 1
a 18 6 n 2
m ..................%%.
m ..................%..
m .....................
m %%...................
m .%...................
m .......%%%...........
m ...%%................
m ....%%...............
m ....%................
m .....................
m .......%%............
m ........%............
m ..............%%%....
m ..........%%.........
m ...........%%........
m ...........%.........
m .....................
m ..............%%.....
m ...............%.....
m %%%..................
m .................%%..
