rows 18
cols 14
players 2
agents_per_player 1
a 9 3 n 0
a 0 10 n 1
m ..............
m ..............
m ...........%%.
m %%..........%%
m .%............
m ..............
m ..............
m ....%.........
m ....%%........
m ..............
m ..............
m ....%%........
m .....%%%%.....
m ........%.....
m ..............
m ..............
m ...........%..
m ...........%%.
