rows 16
cols 14
players 2
agents_per_player 1
a 3 0 n 0
a 11 7 n 1
m ..............
m ..............
m ..............
m ........%.....
m ........%%%...
m ........%.%...
m ..............
m ..............
m ..............
m ..............
m ..............
m .%............
m .%%%..........
m .%.%..........
m ..............
m ..............
