rows 24
cols 24
players 3
agents_per_player 1
a 15 7 n 0
a 23 15 n 1
a 7 23 n 2
m .................%%..%%.
m ......%.%%.......%%...%.
m ....%.%.................
m ....%...................
m ........................
m ........................
m ........................
m .%......................
m .%%..%%.................
m .%%...%.......%.%%......
m ............%.%.........
m ............%...........
m ........................
m ........................
m ........................
m .........%..............
m .........%%..%%.........
m %%.......%%...%.......%.
m ....................%.%.
m ....................%...
m ........................
m ........................
m ........................
m .................%......
