rows 42
cols 42
players 6
agents_per_player 1
a 8 37 n 0
a 15 30 n 1
a 22 23 n 2
a 29 16 n 3
a 36 9 n 4
a 1 2 n 5
m ..........................................
m .........................%%....%...%%.....
m .......................%..%%...%....%.....
m .......................%.%%%.%%%....%.....
m .............................%%%..........
m ..........................................
m ..........................................
m ..........................................
m ..................%%....%...%%............
m ................%..%%...%....%............
m ................%.%%%.%%%....%............
m ......................%%%.................
m ..........................................
m ..........................................
m ..........................................
m ...........%%....%...%%...................
m .........%..%%...%....%...................
m .........%.%%%.%%%....%...................
m ...............%%%........................
m ..........................................
m ..........................................
m ..........................................
m ....%%....%...%%..........................
m ..%..%%...%....%..........................
m ..%.%%%.%%%....%..........................
m ........%%%...............................
m ..........................................
m ..........................................
m ..........................................
m ...%...%%..............................%%.
m ...%....%............................%..%%
m .%%%....%............................%.%%%
m .%%%......................................
m ..........................................
m ..........................................
m ..........................................
m %%..............................%%....%...
m .%............................%..%%...%...
m .%............................%.%%%.%%%...
m ....................................%%%...
m ..........................................
m ..........................................
