rows 14
cols 22
players 2
agents_per_player 1
a 6 16 n 0
a 13 5 n 1
m ......................
m ...%%%................
m ....%%................
m .....%......%.........
m ..........%%%.........
m ............%.........
m ......................
m ......................
m ..............%%%.....
m ...............%%.....
m .%..............%.....
m %%...................%
m .%....................
m ......................
