rows 28
cols 28
players 4
agents_per_player 1
a 7 6 n 0
a 0 27 n 1
a 21 20 n 2
a 14 13 n 3
m ..............%%.....%%.....
m ..............%......%......
m ..%.........................
m ..%.........................
m ............................
m ............................
m %%..................%%%....%
m %%...................%%.....
m %....................%......
m .........%..................
m .........%..................
m ............................
m ............................
m %%....%%%..................%
m %%.....%%...................
m %......%....................
m ................%...........
m ................%...........
m ............................
m ............................
m ......%%%....%%%............
m .......%%.....%%............
m .......%......%.............
m .......................%....
m .......................%....
m ............................
m ............................
m .............%%%....%%%.....
