rows 30
cols 30
players 5
agents_per_player 1
a 16 3 n 0
a 4 9 n 1
a 22 15 n 2
a 10 21 n 3
a 28 27 n 4
m .....................%%.......
m .....................%........
m ...%%.........................
m ..%%%%.%......................
m ..%..%.%......................
m ....%.........................
m ...%%.........................
m ...%..........................
m ...............%%.............
m ..............%%%%.%..........
m ..............%..%.%..........
m ................%.............
m ...............%%.............
m ...............%..............
m ...........................%%.
m .%........................%%%%
m .%........................%..%
m ............................%.
m ...........................%%.
m ...........................%..
m .........%%...................
m ........%%%%.%................
m ........%..%.%................
m ..........%...................
m .........%%...................
m .........%....................
m .....................%%.......
m ....................%%%%.%....
m ....................%..%.%....
m ......................%.......
