rows 30
cols 30
players 3
agents_per_player 1
a 0 0 n 0
a 10 20 n 1
a 20 10 n 2
m ..............................
m ..............................
m ..............................
m ...............%%.............
m ......%........%..............
m ......%.......................
m ..............................
m ..............................
m ..............................
m ..............................
m ..............................
m ..............................
m ..............................
m .....%%.......................
m .....%....................%...
m ..........................%...
m ..............................
m ..............................
m ..............................
m ..............................
m ..............................
m ..............................
m ..............................
m .........................%%...
m ................%........%....
m ................%.............
m ..............................
m ..............................
m ..............................
m ..............................
