rows 49
cols 42
players 7
agents_per_player 1
a 12 10 n 0
a 19 28 n 1
a 26 4 n 2
a 33 22 n 3
a 40 40 n 4
a 47 16 n 5
a 5 34 n 6
m ......................................%%%%
m ......................................%...
m .............................%............
m ............................%%%%..........
m ............................%.%%..........
m ..............%.%%%.......................
m ........%%...%%%%%%.......................
m ..............%%%%........................
m ..............%...........................
m .....%....................................
m ....%%%%..................................
m ....%.%%..................................
m ................................%.%%%.....
m ..........................%%...%%%%%%.....
m ................................%%%%......
m ................................%.........
m .......................%..................
m ......................%%%%................
m ......................%.%%................
m ........%.%%%.............................
m ..%%...%%%%%%.............................
m ........%%%%..............................
m ........%.................................
m .........................................%
m %%......................................%%
m %%......................................%.
m ..........................%.%%%...........
m ....................%%...%%%%%%...........
m ..........................%%%%............
m ..........................%...............
m .................%........................
m ................%%%%......................
m ................%.%%......................
m ..%.%%%...................................
m .%%%%%%...............................%%..
m ..%%%%....................................
m ..%.......................................
m ...................................%......
m ..................................%%%%....
m ..................................%.%%....
m ....................%.%%%.................
m ..............%%...%%%%%%.................
m ....................%%%%..................
m ....................%.....................
m ...........%..............................
m ..........%%%%............................
m ..........%.%%............................
m %.....................................%.%%
m %...............................%%...%%%%%
