rows 24
cols 27
players 3
agents_per_player 1
a 19 18 n 0
a 11 9 n 1
a 3 0 n 2
m .....%............%...%..%.
m .%...%%%..........%%%....%.
m .%.........................
m ...........................
m ...........................
m ...........................
m .................%.........
m ....%............%%........
m %...%..%......%............
m %%%....%..%...%%%..........
m ..........%................
m ...........................
m ...........................
m ...........................
m ..........................%
m %............%............%
m .........%...%..%......%...
m .........%%%....%..%...%%%.
m ...................%.......
m ...........................
m ...........................
m ...........................
m ........%..................
m ........%%............%....
