rows 28
cols 28
players 4
agents_per_player 1
a 1 8 n 0
a 8 15 n 1
a 15 22 n 2
a 22 1 n 3
m ............................
m ............................
m ..%.........................
m ..%%%......%................
m .%%%%......%................
m .%.%%......%................
m .%........%%................
m ............................
m ............................
m .........%..................
m .........%%%......%.........
m ........%%%%......%.........
m ........%.%%......%.........
m ........%........%%.........
m ............................
m ............................
m ................%...........
m ................%%%......%..
m ...............%%%%......%..
m ...............%.%%......%..
m ...............%........%%..
m ............................
m ............................
m .......................%....
m ....%..................%%%..
m ....%.................%%%%..
m ....%.................%.%%..
m ...%%.................%.....
