rows 30
cols 42
players 6
agents_per_player 1
a 27 41 n 0
a 2 6 n 1
a 7 13 n 2
a 12 20 n 3
a 17 27 n 4
a 22 34 n 5
m .....%....................................
m ..................%..................%....
m ................%%%............%%...%%%...
m ............%....%........%%..............
m ...........%%....%........................
m ............%.............................
m ..%......................%................
m .%%%...................%%%............%%..
m ...................%....%........%%.......
m ..................%%....%.................
m ...................%......................
m .........%......................%.........
m ...%%...%%%...................%%%.........
m ..........................%....%........%%
m .........................%%....%..........
m ..........................%...............
m ................%......................%..
m ..........%%...%%%...................%%%..
m .....%%..........................%....%...
m ................................%%....%...
m .................................%........
m ....%..................%..................
m ..%%%............%%...%%%.................
m ...%........%%..........................%.
m ...%...................................%%.
m ........................................%.
m ...........%..................%...........
m .........%%%............%%...%%%..........
m .....%....%........%%.....................
m ....%%....%...............................
