rows 28
cols 28
players 4
agents_per_player 1
a 8 2 n 0
a 15 9 n 1
a 22 16 n 2
a 1 23 n 3
m ............%%..............
m .............%%............%
m .............%.............%
m .............%..............
m .............%..............
m .............%..............
m ...................%%.......
m ...................%%.......
m ......%.............%%......
m ......%.............%.......
m ....................%.......
m ....................%.......
m ....................%.......
m ..........................%%
m ..........................%%
m %............%.............%
m .............%.............%
m ...........................%
m ...........................%
m ...........................%
m .....%%.....................
m .....%%.....................
m ......%%............%.......
m ......%.............%.......
m ......%.....................
m ......%.....................
m ......%.....................
m ............%%..............
