rows 30
cols 24
players 3
agents_per_player 1
a 19 4 n 0
a 9 20 n 1
a 29 12 n 2
m ......%%.............%%.
m .......%%.............%.
m %......%%..............%
m ........................
m ........................
m %.......................
m %......................%
m ........................
m ....%%..................
m .....%.........%........
m .....%%.......%%........
m ......%........%%.......
m .......%%......%%.......
m ........................
m ........................
m ........%...............
m .......%%...............
m ........................
m ............%%..........
m .............%.........%
m .............%%.......%%
m %.............%........%
m %..............%%......%
m ........................
m ........................
m ................%.......
m ...............%%.......
m ........................
m ....................%%..
m .......%.............%..
