rows 26
cols 20
players 2
agents_per_player 1
a 19 12 n 0
a 6 2 n 1
m ....................
m ....................
m %%................%%
m %%....%%.........%%%
m %................%%%
m ...............%%%..
m ...............%%%..
m ....................
m ....................
m ....................
m ....................
m ....................
m ....................
m ....................
m ....................
m ........%%%%........
m .......%%%%%....%%..
m .......%%%%.........
m .....%%%............
m .....%%%............
m ....................
m ....................
m ....................
m ....................
m ....................
m ....................
