rows 21
cols 24
players 3
agents_per_player 1
a 2 18 n 0
a 16 2 n 1
a 9 10 n 2
m ...........%........%...
m ...........%............
m ........................
m .....................%..
m ....................%%..
m ............%...........
m ............%...........
m ...%........%...........
m ...%....................
m ........................
m .............%..........
m ............%%..........
m ....%...................
m ....%...................
m ....%..............%....
m ...................%....
m ........................
m .....%..................
m ....%%..................
m ....................%...
m ....................%...
