rows 30
cols 42
players 6
agents_per_player 1
a 29 23 n 0
a 24 30 n 1
a 19 37 n 2
a 14 2 n 3
a 9 9 n 4
a 4 16 n 5
m .......................................%..
m ...............................%......%%..
m ...............................%%......%..
m ........%%.....................%%.........
m ........%.....................%%%.........
m ................................%.........
m ........................%......%%.........
m ........................%%......%.........
m .%%.....................%%................
m .%.....................%%%................
m .........................%................
m .................%......%%................
m .................%%......%................
m .................%%.................%%....
m ................%%%.................%.....
m ..................%.......................
m ..........%......%%.......................
m ..........%%......%.......................
m ..........%%.................%%...........
m .........%%%.................%............
m ...........%..............................
m ...%......%%..............................
m ...%%......%..............................
m ...%%.................%%..................
m ..%%%.................%...................
m ....%.....................................
m ...%%.................................%...
m ....%.................................%%..
m ...............%%.....................%%..
m ...............%.....................%%%..
