rows 16
cols 14
players 2
agents_per_player 1
a 12 4 n 0
a 4 11 n 1
m ..............
m ..............
m ..............
m ..............
m ..%....%%.....
m ..%...........
m ..............
m ..............
m ..............
m ..............
m ..............
m ..............
m %%.......%....
m .........%....
m ..............
m ..............
