rows 16
cols 20
players 2
agents_per_player 1
a 4 2 n 0
a 12 12 n 1
m ....................
m ....................
m ....................
m ....................
m ........%%..........
m ........%.......%%..
m .....%%.........%...
m .....%%.............
m ....................
m ....................
m ....................
m ....................
m ..................%%
m ......%%..........%.
m ......%........%%...
m ...............%%...
