rows 30
cols 35
players 5
agents_per_player 1
a 12 32 n 0
a 0 18 n 1
a 18 4 n 2
a 6 25 n 3
a 24 11 n 4
m ...%%....%%%%......................
m .........%%........................
m ..%%...............................
m .......................%%..........
m ................%%.................
m ................%%%................
m ..........%%....%%%%...............
m ................%%.................
m .........%%........................
m ..............................%%...
m .......................%%..........
m .......................%%%.........
m .................%%....%%%%........
m .......................%%..........
m ................%%.................
m ..%%...............................
m ..............................%%...
m ..............................%%%..
m ........................%%....%%%%.
m ..............................%%...
m .......................%%..........
m .........%%........................
m ..%%...............................
m ..%%%..............................
m ..%%%%.........................%%..
m ..%%...............................
m ..............................%%...
m ................%%.................
m .........%%........................
m .........%%%.......................
