rows 30
cols 30
players 6
agents_per_player 1
a 17 10 n 0
a 12 5 n 1
a 7 0 n 2
a 2 25 n 3
a 27 20 n 4
a 22 15 n 5
m .%............................
m ..............................
m .....%%.......................
m ......%%......................
m ......%.......................
m ......%.......................
m ..............................
m ..........%%..................
m ...........%%.................
m ...........%..................
m ...........%..................
m ..............................
m ...............%%.............
m ................%%............
m ................%.............
m ................%.............
m ..............................
m ....................%%........
m .....................%%.......
m .....................%........
m .....................%........
m ..............................
m .........................%%...
m ..........................%%..
m ..........................%...
m ..........................%...
m ..............................
m %%............................
m .%%...........................
m .%............................
