rows 26
cols 22
players 2
agents_per_player 1
a 18 5 n 0
a 5 16 n 1
m ..........%%%%%..%....
m ............%%%..%....
m ......................
m ......................
m ......................
m ......................
m ......................
m ......................
m ......................
m ......................
m ......................
m ......................
m .%.%..................
m %%%%..%..............%
m .%%%..%...............
m ......................
m ......................
m ......................
m ......................
m ......................
m ......................
m ......................
m ......................
m ......................
m ......................
m ............%.%.......
