rows 24
cols 27
players 3
agents_per_player 1
a 1 9 n 0
a 9 18 n 1
a 17 0 n 2
m ...........................
m ...........................
m ...........................
m .....................%.....
m .....................%.....
m .....................%%....
m ......................%....
m ...........................
m ...........................
m ...........................
m ...........................
m ...%.......................
m ...%.......................
m ...%%......................
m ....%......................
m ...........................
m ...........................
m ...........................
m ...........................
m ............%..............
m ............%..............
m ............%%.............
m .............%.............
m ...........................
