#
# tron_01.map
#
width 10
height 10
players 2
agents 1

a 0 2 2 s
a 1 7 7 n

m ..........
m ..........
m .......%..
m ..........
m ..........
m ..........
m ..........
m ..%.......
m ..........
m ..........

